南瓜燈	南瓜燈 🎃
聖誕樹	聖誕樹 🎄
煙火	煙火 🎆
煙花棒	煙花棒 🎇
鞭炮	鞭炮 🧨
星光	星光 ✨
氣球	氣球 🎈
派對炮	派對炮 🎉
彩球	彩球 🎊
七夕樹	七夕樹 🎋
松飾	松飾 🎍
雛人偶	雛人偶 🎎
鯉魚旗	鯉魚旗 🎏
風鈴	風鈴 🎐
賞月	賞月 🎑
紅包	紅包 🧧
緞帶	緞帶 🎀
禮物	禮物 🎁
緬懷帶	緬懷帶 🎗️
入場券	入場券 🎟️
門票	門票 🎫
勳章	勳章 🎖️
獎盃	獎盃 🏆
獎牌	獎牌 🏅
金牌	金牌 🥇
銀牌	銀牌 🥈
銅牌	銅牌 🥉
足球	足球 ⚽
棒球	棒球 ⚾
壘球	壘球 🥎
籃球	籃球 🏀
排球	排球 🏐
美式足球	美式足球 🏈
橄欖球	橄欖球 🏉
網球	網球 🎾
飛盤	飛盤 🥏
保齡球	保齡球 🎳
板球	板球 🏏
曲棍球	曲棍球 🏑
冰球	冰球 🏒
長曲棍球	長曲棍球 🥍
乒乓球	乒乓球 🏓
羽毛球	羽毛球 🏸
拳擊手套	拳擊手套 🥊
武術服	武術服 🥋
球門	球門 🥅
高爾夫	高爾夫 ⛳
溜冰鞋	溜冰鞋 ⛸️
釣魚	釣魚 🎣
潛水	潛水 🤿
跑步衣	跑步衣 🎽
滑雪	滑雪 🎿
雪橇	雪橇 🛷
冰壺	冰壺 🥌
飛鏢	飛鏢 🎯
溜溜球	溜溜球 🪀
風箏	風箏 🪁
水槍	水槍 🔫
撞球	撞球 🎱
水晶球	水晶球 🔮
魔杖	魔杖 🪄
遊戲機	遊戲機 🎮
搖桿	搖桿 🕹️
老虎機	老虎機 🎰
骰子	骰子 🎲
拼圖	拼圖 🧩
泰迪熊	泰迪熊 🧸
彩罐	彩罐 🪅
反光球	反光球 🪩
套娃	套娃 🪆
黑桃	黑桃 ♠️
紅心	紅心 ♥️ ❤️
方塊	方塊 ♦️
梅花	梅花 ♣️
棋子	棋子 ♟️
小丑	小丑 🃏 🤡
麻將	麻將 🀄
花牌	花牌 🎴
表演	表演 🎭
畫框	畫框 🖼️
調色盤	調色盤 🎨
線	線 🧵
縫針	縫針 🪡
毛線	毛線 🧶
結	結 🪢
猴臉	猴臉 🐵 🙈 🙉 🙊
猴	猴 🐒
大猩	大猩 🦍
猩猩	猩猩 🦧
狗臉	狗臉 🐶
狗	狗 🐕
導盲	導盲 🦮
工作犬	工作犬 🐕‍🦺
貴賓	貴賓 🐩
狼	狼 🐺
狐	狐 🦊
浣熊	浣熊 🦝
貓臉	貓臉 🐱 😺 😸 😹 😻 😼 😽 🙀 😿 😾
貓	貓 🐈
黑貓	黑貓 🐈‍⬛
獅	獅 🦁
虎臉	虎臉 🐯
虎	虎 🐅
豹	豹 🐆
馬臉	馬臉 🐴
麋鹿	麋鹿 🫎
驢	驢 🫏
馬	馬 🐎
獨角	獨角 🦄
斑馬	斑馬 🦓
鹿	鹿 🦌
野牛	野牛 🦬
牛臉	牛臉 🐮
公牛	公牛 🐂
水牛	水牛 🐃
母牛	母牛 🐄
豬臉	豬臉 🐷
豬	豬 🐖
野豬	野豬 🐗
豬鼻	豬鼻 🐽
公羊	公羊 🐏
母羊	母羊 🐑
山羊	山羊 🐐
駱駝	駱駝 🐪
雙峰	雙峰 🐫
羊駝	羊駝 🦙
長頸	長頸 🦒
象	象 🐘
長毛象	長毛象 🦣
犀牛	犀牛 🦏
河馬	河馬 🦛
鼠臉	鼠臉 🐭
老鼠	老鼠 🐁
大鼠	大鼠 🐀
倉鼠	倉鼠 🐹
兔臉	兔臉 🐰
兔	兔 🐇
花栗鼠	花栗鼠 🐿️
河狸	河狸 🦫
刺蝟	刺蝟 🦔
蝙蝠	蝙蝠 🦇
熊	熊 🐻
北極熊	北極熊 🐻‍❄️
無尾熊	無尾熊 🐨
熊貓	熊貓 🐼
樹懶	樹懶 🦥
水獺	水獺 🦦
臭鼬	臭鼬 🦨
袋鼠	袋鼠 🦘
獾	獾 🦡
爪印	爪印 🐾
火雞	火雞 🦃
雞	雞 🐔
公雞	公雞 🐓
雛雞	雛雞 🐣
小雞	小雞 🐤
小雞臉	小雞臉 🐥
鳥	鳥 🐦
企鵝	企鵝 🐧
鴿	鴿 🕊️
鷹	鷹 🦅
鴨	鴨 🦆
天鵝	天鵝 🦢
貓頭鷹	貓頭鷹 🦉
渡渡鳥	渡渡鳥 🦤
羽毛	羽毛 🪶
火烈鳥	火烈鳥 🦩
孔雀	孔雀 🦚
鸚鵡	鸚鵡 🦜
翅膀	翅膀 🪽
黑鳥	黑鳥 🐦‍⬛
鵝	鵝 🪿
鳳凰	鳳凰 🐦‍🔥
青蛙	青蛙 🐸
鱷魚	鱷魚 🐊
龜	龜 🐢
蜥蜴	蜥蜴 🦎
蛇	蛇 🐍
龍臉	龍臉 🐲
龍	龍 🐉
長頸龍	長頸龍 🦕
暴龍	暴龍 🦖
噴水鯨	噴水鯨 🐳
鯨	鯨 🐋
海豚	海豚 🐬
海豹	海豹 🦭
魚	魚 🐟
熱帶魚	熱帶魚 🐠
河豚	河豚 🐡
鯊魚	鯊魚 🦈
章魚	章魚 🐙
貝殼	貝殼 🐚
珊瑚	珊瑚 🪸
水母	水母 🪼
螃蟹	螃蟹 🦀
龍蝦	龍蝦 🦞
蝦	蝦 🦐
魷魚	魷魚 🦑
牡蠣	牡蠣 🦪
蝸牛	蝸牛 🐌
蝴蝶	蝴蝶 🦋
小蟲	小蟲 🐛
螞蟻	螞蟻 🐜
蜜蜂	蜜蜂 🐝
甲蟲	甲蟲 🪲
瓢蟲	瓢蟲 🐞
蟋蟀	蟋蟀 🦗
蟑螂	蟑螂 🪳
蜘蛛	蜘蛛 🕷️
蜘蛛網	蜘蛛網 🕸️
蠍子	蠍子 🦂
蚊子	蚊子 🦟
蒼蠅	蒼蠅 🪰
蠕蟲	蠕蟲 🪱
微生物	微生物 🦠
花束	花束 💐
櫻花	櫻花 🌸
白花	白花 💮
蓮花	蓮花 🪷
玫瑰花	玫瑰花 🏵️
玫瑰	玫瑰 🌹
枯花	枯花 🥀
木槿	木槿 🌺
向日葵	向日葵 🌻
花朵	花朵 🌼
鬱金香	鬱金香 🌷
風信子	風信子 🪻
幼苗	幼苗 🌱
盆栽	盆栽 🪴
常青樹	常青樹 🌲
落葉樹	落葉樹 🌳
棕櫚樹	棕櫚樹 🌴
仙人掌	仙人掌 🌵
稻穗	稻穗 🌾
草本	草本 🌿
三葉草	三葉草 ☘️
四葉草	四葉草 🍀
楓葉	楓葉 🍁
落葉	落葉 🍂
飄葉	飄葉 🍃
空巢	空巢 🪹
巢蛋	巢蛋 🪺
蘑菇	蘑菇 🍄
枯樹	枯樹 🪾
格旗	格旗 🏁
三角旗	三角旗 🚩
交叉旗	交叉旗 🎌
黑旗	黑旗 🏴
白旗	白旗 🏳️
彩虹旗	彩虹旗 🏳️‍🌈
跨性旗	跨性旗 🏳️‍⚧️
海盜旗	海盜旗 🏴‍☠️
阿森松	阿森松 🇦🇨
安道爾	安道爾 🇦🇩
阿聯酋	阿聯酋 🇦🇪
阿富汗	阿富汗 🇦🇫
安巴	安巴 🇦🇬
安圭拉	安圭拉 🇦🇮
阿爾巴	阿爾巴 🇦🇱
亞美尼亞	亞美尼亞 🇦🇲
安哥拉	安哥拉 🇦🇴
南極	南極 🇦🇶
阿根廷	阿根廷 🇦🇷
美屬薩摩亞	美屬薩摩亞 🇦🇸
奧地利	奧地利 🇦🇹
澳大利亞	澳大利亞 🇦🇺
阿魯巴	阿魯巴 🇦🇼
奧蘭	奧蘭 🇦🇽
阿塞拜疆	阿塞拜疆 🇦🇿
波黑	波黑 🇧🇦
巴巴多斯	巴巴多斯 🇧🇧
孟加拉	孟加拉 🇧🇩
比利時	比利時 🇧🇪
布基納法索	布基納法索 🇧🇫
保加利亞	保加利亞 🇧🇬
巴林	巴林 🇧🇭
布隆迪	布隆迪 🇧🇮
貝寧	貝寧 🇧🇯
聖巴	聖巴 🇧🇱
百慕大	百慕大 🇧🇲
文萊	文萊 🇧🇳
玻利維亞	玻利維亞 🇧🇴
荷屬加勒比	荷屬加勒比 🇧🇶
巴西	巴西 🇧🇷
巴哈馬	巴哈馬 🇧🇸
不丹	不丹 🇧🇹
布韋島	布韋島 🇧🇻
博茨瓦納	博茨瓦納 🇧🇼
白俄羅斯	白俄羅斯 🇧🇾
伯利茲	伯利茲 🇧🇿
加拿大	加拿大 🇨🇦
科科斯	科科斯 🇨🇨
剛果金	剛果金 🇨🇩
中非	中非 🇨🇫
剛果布	剛果布 🇨🇬
瑞士	瑞士 🇨🇭
象牙海岸	象牙海岸 🇨🇮
庫克群島	庫克群島 🇨🇰
智利	智利 🇨🇱
喀麥隆	喀麥隆 🇨🇲
中國	中國 🇨🇳
哥倫比亞	哥倫比亞 🇨🇴
克利珀頓	克利珀頓 🇨🇵
塞克	塞克 🇨🇶
哥斯達黎加	哥斯達黎加 🇨🇷
古巴	古巴 🇨🇺
佛得角	佛得角 🇨🇻
庫拉索	庫拉索 🇨🇼
聖誕島	聖誕島 🇨🇽
塞浦路斯	塞浦路斯 🇨🇾
捷克	捷克 🇨🇿
德國	德國 🇩🇪
迪戈加西亞	迪戈加西亞 🇩🇬
吉布提	吉布提 🇩🇯
丹麥	丹麥 🇩🇰
多米尼克	多米尼克 🇩🇲
多米尼加	多米尼加 🇩🇴
阿爾及利亞	阿爾及利亞 🇩🇿
塞烏塔梅利利亞	塞烏塔梅利利亞 🇪🇦
厄瓜多爾	厄瓜多爾 🇪🇨
愛沙尼亞	愛沙尼亞 🇪🇪
埃及	埃及 🇪🇬
西撒哈拉	西撒哈拉 🇪🇭
厄立特里亞	厄立特里亞 🇪🇷
西班牙	西班牙 🇪🇸
埃塞俄比亞	埃塞俄比亞 🇪🇹
歐盟	歐盟 🇪🇺
芬蘭	芬蘭 🇫🇮
斐濟	斐濟 🇫🇯
福克蘭	福克蘭 🇫🇰
密克羅尼西亞	密克羅尼西亞 🇫🇲
法羅群島	法羅群島 🇫🇴
法國	法國 🇫🇷
加蓬	加蓬 🇬🇦
英國	英國 🇬🇧
格林納達	格林納達 🇬🇩
喬治亞	喬治亞 🇬🇪
法屬圭亞那	法屬圭亞那 🇬🇫
根西	根西 🇬🇬
加納	加納 🇬🇭
直布羅陀	直布羅陀 🇬🇮
格陵蘭	格陵蘭 🇬🇱
岡比亞	岡比亞 🇬🇲
幾內亞	幾內亞 🇬🇳
瓜德羅普	瓜德羅普 🇬🇵
赤道幾內亞	赤道幾內亞 🇬🇶
希臘	希臘 🇬🇷
南喬治亞南三明治	南喬治亞南三明治 🇬🇸
危地馬拉	危地馬拉 🇬🇹
關島	關島 🇬🇺
幾內亞比紹	幾內亞比紹 🇬🇼
圭亞那	圭亞那 🇬🇾
香港	香港 🇭🇰
赫德麥克唐納	赫德麥克唐納 🇭🇲
洪都拉斯	洪都拉斯 🇭🇳
克羅地亞	克羅地亞 🇭🇷
海地	海地 🇭🇹
匈牙利	匈牙利 🇭🇺
加那利群島	加那利群島 🇮🇨
印尼	印尼 🇮🇩
愛爾蘭	愛爾蘭 🇮🇪
以色列	以色列 🇮🇱
曼島	曼島 🇮🇲
印度	印度 🇮🇳
英屬印度洋	英屬印度洋 🇮🇴
伊拉克	伊拉克 🇮🇶
伊朗	伊朗 🇮🇷
冰島	冰島 🇮🇸
意大利	意大利 🇮🇹
澤西	澤西 🇯🇪
牙買加	牙買加 🇯🇲
約旦	約旦 🇯🇴
日本	日本 🇯🇵
肯尼亞	肯尼亞 🇰🇪
吉爾吉斯斯坦	吉爾吉斯斯坦 🇰🇬
柬埔寨	柬埔寨 🇰🇭
基里巴斯	基里巴斯 🇰🇮
科摩羅	科摩羅 🇰🇲
聖基茨尼維斯	聖基茨尼維斯 🇰🇳
朝鮮	朝鮮 🇰🇵
韓國	韓國 🇰🇷
科威特	科威特 🇰🇼
開曼群島	開曼群島 🇰🇾
哈薩克斯坦	哈薩克斯坦 🇰🇿
老撾	老撾 🇱🇦
黎巴嫩	黎巴嫩 🇱🇧
聖盧西亞	聖盧西亞 🇱🇨
列支敦士登	列支敦士登 🇱🇮
斯里蘭卡	斯里蘭卡 🇱🇰
利比里亞	利比里亞 🇱🇷
萊索托	萊索托 🇱🇸
立陶宛	立陶宛 🇱🇹
盧森堡	盧森堡 🇱🇺
拉脫維亞	拉脫維亞 🇱🇻
利比亞	利比亞 🇱🇾
摩洛哥	摩洛哥 🇲🇦
摩納哥	摩納哥 🇲🇨
摩爾多瓦	摩爾多瓦 🇲🇩
黑山	黑山 🇲🇪
聖馬丁	聖馬丁 🇲🇫 🇸🇽
馬達加斯加	馬達加斯加 🇲🇬
馬紹爾群島	馬紹爾群島 🇲🇭
北馬其頓	北馬其頓 🇲🇰
馬里	馬里 🇲🇱
緬甸	緬甸 🇲🇲
蒙古	蒙古 🇲🇳
澳門	澳門 🇲🇴
北馬里亞納群島	北馬里亞納群島 🇲🇵
馬提尼克	馬提尼克 🇲🇶
毛里塔尼亞	毛里塔尼亞 🇲🇷
蒙特塞拉特	蒙特塞拉特 🇲🇸
馬耳他	馬耳他 🇲🇹
毛里求斯	毛里求斯 🇲🇺
馬爾代夫	馬爾代夫 🇲🇻
馬拉維	馬拉維 🇲🇼
墨西哥	墨西哥 🇲🇽
馬來西亞	馬來西亞 🇲🇾
莫桑比克	莫桑比克 🇲🇿
納米比亞	納米比亞 🇳🇦
新喀里多尼亞	新喀里多尼亞 🇳🇨
尼日爾	尼日爾 🇳🇪
諾福克島	諾福克島 🇳🇫
尼日利亞	尼日利亞 🇳🇬
尼加拉瓜	尼加拉瓜 🇳🇮
荷蘭	荷蘭 🇳🇱
挪威	挪威 🇳🇴
尼泊爾	尼泊爾 🇳🇵
瑙魯	瑙魯 🇳🇷
紐埃	紐埃 🇳🇺
新西蘭	新西蘭 🇳🇿
阿曼	阿曼 🇴🇲
巴拿馬	巴拿馬 🇵🇦
秘魯	秘魯 🇵🇪
法屬波利尼西亞	法屬波利尼西亞 🇵🇫
巴布亞新幾內亞	巴布亞新幾內亞 🇵🇬
菲律賓	菲律賓 🇵🇭
巴基斯坦	巴基斯坦 🇵🇰
波蘭	波蘭 🇵🇱
聖皮埃爾密克隆	聖皮埃爾密克隆 🇵🇲
皮特凱恩群島	皮特凱恩群島 🇵🇳
波多黎各	波多黎各 🇵🇷
巴勒斯坦	巴勒斯坦 🇵🇸
葡萄牙	葡萄牙 🇵🇹
帕勞	帕勞 🇵🇼
巴拉圭	巴拉圭 🇵🇾
卡塔爾	卡塔爾 🇶🇦
留尼汪	留尼汪 🇷🇪
羅馬尼亞	羅馬尼亞 🇷🇴
塞爾維亞	塞爾維亞 🇷🇸
俄羅斯	俄羅斯 🇷🇺
盧旺達	盧旺達 🇷🇼
沙特	沙特 🇸🇦
所羅門群島	所羅門群島 🇸🇧
塞舌爾	塞舌爾 🇸🇨
蘇丹	蘇丹 🇸🇩
瑞典	瑞典 🇸🇪
新加坡	新加坡 🇸🇬
聖赫勒拿	聖赫勒拿 🇸🇭
斯洛文尼亞	斯洛文尼亞 🇸🇮
斯瓦爾巴揚馬延	斯瓦爾巴揚馬延 🇸🇯
斯洛伐克	斯洛伐克 🇸🇰
塞拉利昂	塞拉利昂 🇸🇱
聖馬力諾	聖馬力諾 🇸🇲
塞內加爾	塞內加爾 🇸🇳
索馬里	索馬里 🇸🇴
蘇里南	蘇里南 🇸🇷
南蘇丹	南蘇丹 🇸🇸
聖多美普林西比	聖多美普林西比 🇸🇹
薩爾瓦多	薩爾瓦多 🇸🇻
敘利亞	敘利亞 🇸🇾
斯威士蘭	斯威士蘭 🇸🇿
特里斯坦達庫尼亞	特里斯坦達庫尼亞 🇹🇦
特克斯凱科斯群島	特克斯凱科斯群島 🇹🇨
乍得	乍得 🇹🇩
法屬南部領地	法屬南部領地 🇹🇫
多哥	多哥 🇹🇬
泰國	泰國 🇹🇭
塔吉克斯坦	塔吉克斯坦 🇹🇯
托克勞	托克勞 🇹🇰
東帝汶	東帝汶 🇹🇱
土庫曼斯坦	土庫曼斯坦 🇹🇲
突尼斯	突尼斯 🇹🇳
湯加	湯加 🇹🇴
土耳其	土耳其 🇹🇷
特立尼達多巴哥	特立尼達多巴哥 🇹🇹
圖瓦盧	圖瓦盧 🇹🇻
台灣	台灣 🇹🇼
坦桑尼亞	坦桑尼亞 🇹🇿
烏克蘭	烏克蘭 🇺🇦
烏干達	烏干達 🇺🇬
美國邊遠島嶼	美國邊遠島嶼 🇺🇲
聯合國	聯合國 🇺🇳
美國	美國 🇺🇸
烏拉圭	烏拉圭 🇺🇾
烏茲別克斯坦	烏茲別克斯坦 🇺🇿
梵蒂岡	梵蒂岡 🇻🇦
聖文森特格林納丁斯	聖文森特格林納丁斯 🇻🇨
委內瑞拉	委內瑞拉 🇻🇪
英屬維爾京群島	英屬維爾京群島 🇻🇬
美屬維爾京群島	美屬維爾京群島 🇻🇮
越南	越南 🇻🇳
瓦努阿圖	瓦努阿圖 🇻🇺
瓦利斯富圖納	瓦利斯富圖納 🇼🇫
薩摩亞	薩摩亞 🇼🇸
科索沃	科索沃 🇽🇰
也門	也門 🇾🇪
馬約特	馬約特 🇾🇹
南非	南非 🇿🇦
贊比亞	贊比亞 🇿🇲
津巴布韋	津巴布韋 🇿🇼
英格蘭	英格蘭 🏴󠁧󠁢󠁥󠁮󠁧󠁿
蘇格蘭	蘇格蘭 🏴󠁧󠁢󠁳󠁣󠁴󠁿
威爾士	威爾士 🏴󠁧󠁢󠁷󠁬󠁳󠁿
葡萄	葡萄 🍇
哈密瓜	哈密瓜 🍈
西瓜	西瓜 🍉
橘子	橘子 🍊
檸檬	檸檬 🍋
萊姆	萊姆 🍋‍🟩
香蕉	香蕉 🍌
鳳梨	鳳梨 🍍
芒果	芒果 🥭
紅蘋果	紅蘋果 🍎
青蘋果	青蘋果 🍏
梨	梨 🍐
桃子	桃子 🍑
櫻桃	櫻桃 🍒
草莓	草莓 🍓
藍莓	藍莓 🫐
奇異果	奇異果 🥝
番茄	番茄 🍅
橄欖	橄欖 🫒
椰子	椰子 🥥
酪梨	酪梨 🥑
茄子	茄子 🍆
馬鈴薯	馬鈴薯 🥔
胡蘿蔔	胡蘿蔔 🥕
玉米	玉米 🌽
辣椒	辣椒 🌶️
甜椒	甜椒 🫑
小黃瓜	小黃瓜 🥒
綠葉菜	綠葉菜 🥬
花椰菜	花椰菜 🥦
大蒜	大蒜 🧄
洋蔥	洋蔥 🧅
花生	花生 🥜
豆子	豆子 🫘
栗子	栗子 🌰
薑	薑 🫚
豌豆	豌豆 🫛
棕菇	棕菇 🍄‍🟫
根菜	根菜 🫜
麵包	麵包 🍞
可頌	可頌 🥐
法棍	法棍 🥖
薄餅	薄餅 🫓
椒鹽捲餅	椒鹽捲餅 🥨
貝果	貝果 🥯
鬆餅	鬆餅 🥞
格子餅	格子餅 🧇
起司	起司 🧀
肉骨	肉骨 🍖
雞腿	雞腿 🍗
肉排	肉排 🥩
培根	培根 🥓
漢堡	漢堡 🍔
薯條	薯條 🍟
披薩	披薩 🍕
熱狗	熱狗 🌭
三明治	三明治 🥪
塔可	塔可 🌮
墨西哥捲	墨西哥捲 🌯
玉米粽	玉米粽 🫔
夾餅	夾餅 🥙
炸豆丸	炸豆丸 🧆
雞蛋	雞蛋 🥚
煎蛋	煎蛋 🍳
平底鍋菜	平底鍋菜 🥘
鍋菜	鍋菜 🍲
起司火鍋	起司火鍋 🫕
湯碗	湯碗 🥣
沙拉	沙拉 🥗
爆米花	爆米花 🍿
奶油	奶油 🧈
鹽	鹽 🧂
罐頭	罐頭 🥫
便當	便當 🍱
米餅	米餅 🍘
飯糰	飯糰 🍙
白飯	白飯 🍚
咖哩飯	咖哩飯 🍛
湯麵	湯麵 🍜
義大利麵	義大利麵 🍝
烤地瓜	烤地瓜 🍠
關東煮	關東煮 🍢
壽司	壽司 🍣
炸蝦	炸蝦 🍤
魚板	魚板 🍥
月餅	月餅 🥮
糯米糰	糯米糰 🍡
餃子	餃子 🥟
幸運餅乾	幸運餅乾 🥠
外賣盒	外賣盒 🥡
霜淇淋	霜淇淋 🍦
刨冰	刨冰 🍧
冰淇淋	冰淇淋 🍨
甜甜圈	甜甜圈 🍩
餅乾	餅乾 🍪
蛋糕	蛋糕 🎂
草莓蛋糕	草莓蛋糕 🍰
杯子蛋糕	杯子蛋糕 🧁
派	派 🥧
巧克力	巧克力 🍫
糖果	糖果 🍬
棒棒糖	棒棒糖 🍭
布丁	布丁 🍮
蜂蜜	蜂蜜 🍯
奶瓶	奶瓶 🍼
牛奶	牛奶 🥛
熱飲	熱飲 ☕
茶壺	茶壺 🫖
茶杯	茶杯 🍵
清酒	清酒 🍶
香檳	香檳 🍾
紅酒	紅酒 🍷
雞尾酒	雞尾酒 🍸
熱帶飲料	熱帶飲料 🍹
啤酒	啤酒 🍺
啤酒乾杯	啤酒乾杯 🍻
乾杯	乾杯 🥂
威士忌	威士忌 🥃
倒飲料	倒飲料 🫗
吸管杯	吸管杯 🥤
珍珠奶茶	珍珠奶茶 🧋
飲料盒	飲料盒 🧃
馬黛茶	馬黛茶 🧉
冰塊	冰塊 🧊
筷子	筷子 🥢
餐盤	餐盤 🍽️
刀叉	刀叉 🍴
湯匙	湯匙 🥄
菜刀	菜刀 🔪
罐子	罐子 🫙
陶罐	陶罐 🏺
眼鏡	眼鏡 👓 😎 🤓 🧐
墨鏡	墨鏡 🕶️ 😎
護目鏡	護目鏡 🥽
白袍	白袍 🥼
反光衣	反光衣 🦺
領帶	領帶 👔
T恤	T恤 👕
牛仔褲	牛仔褲 👖
圍巾	圍巾 🧣
手套	手套 🧤
外套	外套 🧥
襪子	襪子 🧦
洋裝	洋裝 👗
和服	和服 👘
莎麗	莎麗 🥻
連身泳衣	連身泳衣 🩱
三角褲	三角褲 🩲
短褲	短褲 🩳
比基尼	比基尼 👙
女裝	女裝 👚
摺扇	摺扇 🪭
錢包	錢包 👛
手提包	手提包 👜
手拿包	手拿包 👝
購物袋	購物袋 🛍️
背包	背包 🎒
夾腳拖	夾腳拖 🩴
男鞋	男鞋 👞
跑鞋	跑鞋 👟
登山靴	登山靴 🥾
平底鞋	平底鞋 🥿
高跟鞋	高跟鞋 👠
涼鞋	涼鞋 👡
芭蕾鞋	芭蕾鞋 🩰
女靴	女靴 👢
髮梳	髮梳 🪮
皇冠	皇冠 👑
女帽	女帽 👒
禮帽	禮帽 🎩
畢業帽	畢業帽 🎓
鴨舌帽	鴨舌帽 🧢
軍帽	軍帽 🪖
救援帽	救援帽 ⛑️
念珠	念珠 📿
口紅	口紅 💄
戒指	戒指 💍
寶石	寶石 💎
靜音	靜音 🔇
小聲	小聲 🔈
中聲	中聲 🔉
大聲	大聲 🔊
喇叭	喇叭 📢
擴音器	擴音器 📣
號角	號角 📯
鈴鐺	鈴鐺 🔔
禁鈴	禁鈴 🔕
樂譜	樂譜 🎼
音符	音符 🎵
音符群	音符群 🎶
麥克風	麥克風 🎙️ 🎤
音量條	音量條 🎚️
控制鈕	控制鈕 🎛️
耳機	耳機 🎧
收音機	收音機 📻
薩克斯	薩克斯 🎷
手風琴	手風琴 🪗
吉他	吉他 🎸
鍵盤	鍵盤 🎹 ⌨️
小號	小號 🎺
小提琴	小提琴 🎻
班卓琴	班卓琴 🪕
鼓	鼓 🥁
長鼓	長鼓 🪘
沙鈴	沙鈴 🪇
長笛	長笛 🪈
豎琴	豎琴 🪉
手機	手機 📱
手機箭頭	手機箭頭 📲
座機	座機 ☎️
話筒	話筒 📞
傳呼機	傳呼機 📟
傳真機	傳真機 📠
電池	電池 🔋
低電量	低電量 🪫
插頭	插頭 🔌
筆記本	筆記本 💻 📓
台式機	台式機 🖥️
打印機	打印機 🖨️
鼠標	鼠標 🖱️
軌跡球	軌跡球 🖲️
電腦磁盤	電腦磁盤 💽
軟盤	軟盤 💾
光盤	光盤 💿
DVD	DVD 📀
算盤	算盤 🧮
攝影機	攝影機 🎥
膠片	膠片 🎞️
放映機	放映機 📽️
拍板	拍板 🎬
電視	電視 📺
相機	相機 📷
閃光相機	閃光相機 📸
攝像機	攝像機 📹
錄影帶	錄影帶 📼
左放大鏡	左放大鏡 🔍
右放大鏡	右放大鏡 🔎
蠟燭	蠟燭 🕯️
燈泡	燈泡 💡
手電筒	手電筒 🔦
紅燈籠	紅燈籠 🏮
印度燈	印度燈 🪔
裝飾筆記本	裝飾筆記本 📔
閉合書	閉合書 📕
打開書	打開書 📖
綠書	綠書 📗
藍書	藍書 📘
橙書	橙書 📙
書籍	書籍 📚
賬簿	賬簿 📒
卷頁	卷頁 📃
卷軸	卷軸 📜
向上頁	向上頁 📄
報紙	報紙 📰
卷報紙	卷報紙 🗞️
書籤	書籤 📑 🔖
標籤	標籤 🏷️
錢袋	錢袋 💰
硬幣	硬幣 🪙
日元	日元 💴
美元	美元 💵 💲
歐元	歐元 💶
英鎊	英鎊 💷
飛錢	飛錢 💸
信用卡	信用卡 💳
收據	收據 🧾
日元增長	日元增長 💹
信封	信封 ✉️
電子郵件	電子郵件 📧
收信	收信 📨
信封箭頭	信封箭頭 📩
發件箱	發件箱 📤
收件箱	收件箱 📥
包裹	包裹 📦
閉合郵箱	閉合郵箱 📫 📪
打開郵箱	打開郵箱 📬 📭
郵筒	郵筒 📮
投票箱	投票箱 🗳️
鉛筆	鉛筆 ✏️
黑筆尖	黑筆尖 ✒️
鋼筆	鋼筆 🖋️
筆	筆 🖊️
畫筆	畫筆 🖌️
蠟筆	蠟筆 🖍️
備忘錄	備忘錄 📝
公文包	公文包 💼
文件夾	文件夾 📁
打開文件夾	打開文件夾 📂
卡片索引	卡片索引 🗂️ 📇
日曆	日曆 📅
撕下日曆	撕下日曆 📆
螺旋筆記本	螺旋筆記本 🗒️
螺旋日曆	螺旋日曆 🗓️
增長圖	增長圖 📈
減少圖	減少圖 📉
柱狀圖	柱狀圖 📊
剪貼板	剪貼板 📋
大頭針	大頭針 📌
圓大頭針	圓大頭針 📍
回形針	回形針 📎
連接回形針	連接回形針 🖇️
直尺	直尺 📏
三角尺	三角尺 📐
剪刀	剪刀 ✂️
卡片文件箱	卡片文件箱 🗃️
文件櫃	文件櫃 🗄️
垃圾桶	垃圾桶 🗑️
鎖定	鎖定 🔒
解鎖	解鎖 🔓
鎖筆	鎖筆 🔏
鎖鑰	鎖鑰 🔐
鑰匙	鑰匙 🔑
老鑰匙	老鑰匙 🗝️
錘子	錘子 🔨
斧頭	斧頭 🪓
鶴嘴鋤	鶴嘴鋤 ⛏️
錘和鋤	錘和鋤 ⚒️
錘和扳手	錘和扳手 🛠️
匕首	匕首 🗡️
交叉劍	交叉劍 ⚔️
炸彈	炸彈 💣
回力鏢	回力鏢 🪃
弓箭	弓箭 🏹
盾牌	盾牌 🛡️
木工鋸	木工鋸 🪚
扳手	扳手 🔧
螺絲刀	螺絲刀 🪛
螺母和螺栓	螺母和螺栓 🔩
齒輪	齒輪 ⚙️
夾子	夾子 🗜️
天平	天平 ⚖️
白手杖	白手杖 🦯
鏈接	鏈接 🔗
斷鏈	斷鏈 ⛓️‍💥
鏈條	鏈條 ⛓️
鉤子	鉤子 🪝
工具箱	工具箱 🧰
磁鐵	磁鐵 🧲
梯子	梯子 🪜
鏟子	鏟子 🪏
蒸餾器	蒸餾器 ⚗️
試管	試管 🧪
培養皿	培養皿 🧫
DNA	DNA 🧬
顯微鏡	顯微鏡 🔬
望遠鏡	望遠鏡 🔭
衛星天線	衛星天線 📡
注射器	注射器 💉
血滴	血滴 🩸
藥丸	藥丸 💊
創可貼	創可貼 🩹
拐杖	拐杖 🩼
聽診器	聽診器 🩺
X光	X光 🩻
門	門 🚪
電梯	電梯 🛗
鏡子	鏡子 🪞
窗戶	窗戶 🪟
床	床 🛏️
沙發和燈	沙發和燈 🛋️
椅子	椅子 🪑
馬桶	馬桶 🚽
馬桶吸	馬桶吸 🪠
淋浴	淋浴 🚿
浴缸	浴缸 🛁
捕鼠器	捕鼠器 🪤
剃刀	剃刀 🪒
潤膚瓶	潤膚瓶 🧴
安全別針	安全別針 🧷
掃帚	掃帚 🧹
籃子	籃子 🧺
紙卷	紙卷 🧻
桶	桶 🪣
肥皂	肥皂 🧼
泡泡	泡泡 🫧
牙刷	牙刷 🪥
海綿	海綿 🧽
滅火器	滅火器 🧯
購物車	購物車 🛒
香煙	香煙 🚬
棺材	棺材 ⚰️
墓碑	墓碑 🪦
骨灰罈	骨灰罈 ⚱️
護身符	護身符 🧿
哈姆薩	哈姆薩 🪬
摩艾	摩艾 🗿
標語牌	標語牌 🪧
身份證	身份證 🪪
讚	讚 👍 👏 🙌
噓	噓 👎
拳頭	拳頭 ✊
揮拳	揮拳 👊
左拳	左拳 🤛
右拳	右拳 🤜
鼓掌	鼓掌 👏
舉手	舉手 🙌
愛心手	愛心手 🫶
張手	張手 👐
合掌	合掌 🤲
握手	握手 🤝
祈禱	祈禱 🙏
寫字	寫字 ✍️
指甲油	指甲油 💅
自拍	自拍 🤳
笑臉	笑臉 😀 ☺️
大笑	大笑 😃
笑眼	笑眼 😄
開心	開心 😁
笑眯	笑眯 😆
苦笑	苦笑 😅
笑翻	笑翻 🤣
笑哭	笑哭 😂
微笑	微笑 🙂 😏 😀 😃 😄 😁 😆 😅 🤣 😂 🙃 🫠 😉 😊 😇
倒笑	倒笑 🙃
融化	融化 🫠
眨眼	眨眼 😉
笑容	笑容 😊
天使	天使 😇
心笑	心笑 🥰
愛心	愛心 😍
星眼	星眼 🤩
飛吻	飛吻 😘
親吻	親吻 😗
親臉	親臉 😚
笑吻	笑吻 😙
淚笑	淚笑 🥲
美味	美味 😋
舌臉	舌臉 😛
眨舌	眨舌 😜
搞怪	搞怪 🤪
笑舌	笑舌 😝
錢嘴	錢嘴 🤑
擁抱	擁抱 🤗
捂嘴	捂嘴 🤭
驚訝	驚訝 🫢 😲
偷看	偷看 🫣
噓聲	噓聲 🤫
思考	思考 🤔
敬禮	敬禮 🫡
閉嘴	閉嘴 🤐
挑眉	挑眉 🤨
平臉	平臉 😐
無表情	無表情 😑
無嘴	無嘴 😶
虛線	虛線 🫥
雲臉	雲臉 😶‍🌫️
不悅	不悅 😒
翻眼	翻眼 🙄
齜牙	齜牙 😬
吐氣	吐氣 😮‍💨
說謊	說謊 🤥
震臉	震臉 🫨
左右	左右 🙂‍↔️ ↔️
上下	上下 🙂‍↕️ ↕️
放鬆	放鬆 😌
沉思	沉思 😔
睏臉	睏臉 😪
流口	流口 🤤
睡覺	睡覺 😴
黑眼	黑眼 🫩
口罩	口罩 😷
發燒	發燒 🤒
包頭	包頭 🤕
噁心	噁心 🤢
嘔吐	嘔吐 🤮
打噴	打噴 🤧
熱臉	熱臉 🥵
冷臉	冷臉 🥶
暈臉	暈臉 🥴
眩暈	眩暈 😵 💫
旋眼	旋眼 😵‍💫
爆頭	爆頭 🤯
牛仔	牛仔 🤠
派對	派對 🥳
偽裝	偽裝 🥸
書呆	書呆 🤓
單鏡	單鏡 🧐
困惑	困惑 😕 😖
斜嘴	斜嘴 🫤
擔心	擔心 😟
微皺	微皺 🙁
皺眉	皺眉 ☹️
張嘴	張嘴 😮
安靜	安靜 😯
臉紅	臉紅 😳
哀求	哀求 🥺
忍淚	忍淚 🥹
張皺	張皺 😦
痛苦	痛苦 😧
害怕	害怕 😨
焦慮	焦慮 😰
悲鬆	悲鬆 😥
哭泣	哭泣 😢
大哭	大哭 😭
尖叫	尖叫 😱
堅持	堅持 😣
失望	失望 😞
沮喪	沮喪 😓
疲憊	疲憊 😩
疲倦	疲倦 😫
打哈	打哈 🥱
冒氣	冒氣 😤
憤怒	憤怒 😡
生氣	生氣 😠
咒罵	咒罵 🤬
惡笑	惡笑 😈
惡怒	惡怒 👿
骷髏	骷髏 💀 ☠️
糞便	糞便 💩
怪物	怪物 👹
妖怪	妖怪 👺
鬼魂	鬼魂 👻
外星	外星 👽
怪獸	怪獸 👾
機器	機器 🤖
貓笑	貓笑 😺 😼
貓眼	貓眼 😸
貓哭	貓哭 😹
貓愛	貓愛 😻
貓吻	貓吻 😽
貓累	貓累 🙀
貓泣	貓泣 😿
貓怒	貓怒 😾
遮眼	遮眼 🙈
遮耳	遮耳 🙉
遮嘴	遮嘴 🙊
情書	情書 💌
箭心	箭心 💘
禮心	禮心 💝
閃心	閃心 💖
長心	長心 💗
跳心	跳心 💓
轉心	轉心 💞
雙心	雙心 💕
裝心	裝心 💟
驚心	驚心 ❣️
碎心	碎心 💔
火心	火心 ❤️‍🔥
補心	補心 ❤️‍🩹
粉心	粉心 🩷
橙心	橙心 🧡
黃心	黃心 💛
綠心	綠心 💚
藍心	藍心 💙
淡藍	淡藍 🩵
紫心	紫心 💜
棕心	棕心 🤎
黑心	黑心 🖤
灰心	灰心 🩶
白心	白心 🤍
唇印	唇印 💋
百分	百分 💯
怒符	怒符 💢
碰撞	碰撞 💥
汗滴	汗滴 💦
飛奔	飛奔 💨
洞	洞 🕳️
氣泡	氣泡 💬
眼泡	眼泡 👁️‍🗨️
左泡	左泡 🗨️
怒泡	怒泡 🗯️
思泡	思泡 💭
睡聲	睡聲 💤
提款機	提款機 🏧
丟垃圾	丟垃圾 🚮
可飲水	可飲水 🚰
輪椅	輪椅 ♿
男廁	男廁 🚹
女廁	女廁 🚺
廁所	廁所 🚻
嬰兒	嬰兒 🚼
洗手間	洗手間 🚾
護照	護照 🛂
海關	海關 🛃
行李	行李 🛄 🧳
寄存	寄存 🛅
警告	警告 ⚠️ 🚸 ⛔ 🚫 🚳 🚭 🚯 🚱 🚷 📵 🔞 ☢️ ☣️
孩童	孩童 🚸
禁止	禁止 ⛔ 🚫 🈲
停止	停止 ⛔ ⏹️
禁止自行車	禁止自行車 🚳
禁止吸煙	禁止吸煙 🚭
禁止丟垃圾	禁止丟垃圾 🚯
非飲用水	非飲用水 🚱
禁止行人	禁止行人 🚷
禁止手機	禁止手機 📵
未滿十八	未滿十八 🔞
放射	放射 ☢️
輻射	輻射 ☢️
生物危害	生物危害 ☣️
向上	向上 ⬆️ 🔼 🆙 📈
右上	右上 ↗️
向右	向右 ➡️
右下	右下 ↘️
向下	向下 ⬇️ 🔽 📉
左下	左下 ↙️
向左	向左 ⬅️
左上	左上 ↖️
右轉左	右轉左 ↩️
左轉右	左轉右 ↪️
右轉上	右轉上 ⤴️
右轉下	右轉下 ⤵️
順時針	順時針 🔃
逆時針	逆時針 🔄
返回	返回 🔙
結束	結束 🔚
開啟	開啟 🔛
即將	即將 🔜
頂部	頂部 🔝
禮拜	禮拜 🛐
原子	原子 ⚛️
唵	唵 🕉️
大衛星	大衛星 ✡️
法輪	法輪 ☸️
陰陽	陰陽 ☯️
十字架	十字架 ✝️
東正十字	東正十字 ☦️
星月	星月 ☪️
和平	和平 ☮️
燭台	燭台 🕎
六角星	六角星 🔯
卡達	卡達 🪯
白羊座	白羊座 ♈
金牛座	金牛座 ♉
雙子座	雙子座 ♊
巨蟹座	巨蟹座 ♋
獅子座	獅子座 ♌
處女座	處女座 ♍
天秤座	天秤座 ♎
天蠍座	天蠍座 ♏
射手座	射手座 ♐
摩羯座	摩羯座 ♑
水瓶座	水瓶座 ♒
雙魚座	雙魚座 ♓
蛇夫座	蛇夫座 ⛎
隨機播放	隨機播放 🔀
重複	重複 🔁
單曲重複	單曲重複 🔂
播放	播放 ▶️
快進	快進 ⏩
下一曲	下一曲 ⏭️
播放暫停	播放暫停 ⏯️
倒退	倒退 ◀️
快退	快退 ⏪
上一曲	上一曲 ⏮️
快速向上	快速向上 ⏫
快速向下	快速向下 ⏬
暫停	暫停 ⏸️
錄音	錄音 ⏺️
彈出	彈出 ⏏️
電影院	電影院 🎦
暗	暗 🔅
亮	亮 🔆
信號	信號 📶
無線	無線 🛜
震動	震動 📳
手機關閉	手機關閉 📴
女性	女性 ♀️
男性	男性 ♂️
跨性別	跨性別 ⚧️
乘	乘 ✖️
加	加 ➕
減	減 ➖
除	除 ➗
等於	等於 🟰
無限	無限 ♾️
雙驚嘆號	雙驚嘆號 ‼️
驚嘆問號	驚嘆問號 ⁉️
紅問號	紅問號 ❓
白問號	白問號 ❔
白驚嘆號	白驚嘆號 ❕
紅驚嘆號	紅驚嘆號 ❗
波浪線	波浪線 〰️
貨幣兌換	貨幣兌換 💱
醫療	醫療 ⚕️ 💉 🩸 💊 🩹 🩼 🩺 🩻
回收	回收 ♻️
百合花	百合花 ⚜️
三叉戟	三叉戟 🔱
名牌	名牌 📛
初學者	初學者 🔰
空心紅圈	空心紅圈 ⭕
勾選	勾選 ✅
勾選框	勾選框 ☑️
勾	勾 ✔️
叉	叉 ❌
叉按鈕	叉按鈕 ❎
彎曲環	彎曲環 ➰
雙彎曲環	雙彎曲環 ➿
部分交替	部分交替 〽️
八角星	八角星 ✳️ ✴️
閃光	閃光 ❇️
版權	版權 ©️
註冊	註冊 ®️
商標	商標 ™️
濺射	濺射 🫟
鍵帽#	鍵帽# #️⃣
鍵帽*	鍵帽* *️⃣
鍵帽0	鍵帽0 0️⃣
鍵帽1	鍵帽1 1️⃣
鍵帽2	鍵帽2 2️⃣
鍵帽3	鍵帽3 3️⃣
鍵帽4	鍵帽4 4️⃣
鍵帽5	鍵帽5 5️⃣
鍵帽6	鍵帽6 6️⃣
鍵帽7	鍵帽7 7️⃣
鍵帽8	鍵帽8 8️⃣
鍵帽9	鍵帽9 9️⃣
鍵帽10	鍵帽10 🔟
大寫字母	大寫字母 🔠
小寫字母	小寫字母 🔡
數字	數字 🔢
符號	符號 🔣
拉丁字母	拉丁字母 🔤
A型	A型 🅰️
AB型	AB型 🆎
B型	B型 🅱️
CL	CL 🆑
酷	酷 🆒
免費	免費 🆓 🈚
信息	信息 ℹ️
身份	身份 🆔
圈M	圈M Ⓜ️
新	新 🆕
NG	NG 🆖
O型	O型 🅾️
好	好 🆗
P	P 🅿️
求救	求救 🆘
對比	對比 🆚
這裡	這裡 🈁
服務費	服務費 🈂️
月費	月費 🈷️
收費	收費 🈶
預留	預留 🈯
優惠	優惠 🉐
折扣	折扣 🈹
可接受	可接受 🉑
申請	申請 🈸
合格	合格 🈴
空缺	空缺 🈳
恭喜	恭喜 ㊗️
秘密	秘密 ㊙️
營業	營業 🈺
滿員	滿員 🈵
紅圈	紅圈 🔴
橙圈	橙圈 🟠
黃圈	黃圈 🟡
綠圈	綠圈 🟢
藍圈	藍圈 🔵
紫圈	紫圈 🟣
棕圈	棕圈 🟤
黑圈	黑圈 ⚫
白圈	白圈 ⚪
紅方塊	紅方塊 🟥
橙方塊	橙方塊 🟧
黃方塊	黃方塊 🟨
綠方塊	綠方塊 🟩
藍方塊	藍方塊 🟦
紫方塊	紫方塊 🟪
棕方塊	棕方塊 🟫
黑大方塊	黑大方塊 ⬛
白大方塊	白大方塊 ⬜
黑中方塊	黑中方塊 ◼️
白中方塊	白中方塊 ◻️
黑小方塊	黑小方塊 ◾ ▪️
白小方塊	白小方塊 ◽ ▫️
橙大菱形	橙大菱形 🔶
藍大菱形	藍大菱形 🔷
橙小菱形	橙小菱形 🔸
藍小菱形	藍小菱形 🔹
紅三角	紅三角 🔺
紅倒三角	紅倒三角 🔻
點菱形	點菱形 💠
圓形按鈕	圓形按鈕 🔘
白方形按鈕	白方形按鈕 🔳
黑方形按鈕	黑方形按鈕 🔲
歐非	歐非 🌍
美洲	美洲 🌎
亞澳	亞澳 🌏
經緯	經緯 🌐
世界地圖	世界地圖 🗺️
日本地圖	日本地圖 🗾
指南針	指南針 🧭
雪山	雪山 🏔️
山	山 ⛰️
火山	火山 🌋
富士山	富士山 🗻
露營	露營 🏕️
海灘	海灘 🏖️
沙漠	沙漠 🏜️
荒島	荒島 🏝️
國家公園	國家公園 🏞️
體育場	體育場 🏟️
古典建築	古典建築 🏛️
建築施工	建築施工 🏗️
磚	磚 🧱
岩石	岩石 🪨
木材	木材 🪵
小屋	小屋 🛖
房屋	房屋 🏘️
廢棄房屋	廢棄房屋 🏚️
房子	房子 🏠
花園房子	花園房子 🏡
辦公樓	辦公樓 🏢
日本郵局	日本郵局 🏣
郵局	郵局 🏤
醫院	醫院 🏥
銀行	銀行 🏦
酒店	酒店 🏨 🛎️ 🧳
情侶酒店	情侶酒店 🏩
便利店	便利店 🏪
學校	學校 🏫
百貨商店	百貨商店 🏬
工廠	工廠 🏭
日本城堡	日本城堡 🏯
城堡	城堡 🏰
婚禮	婚禮 💒
東京塔	東京塔 🗼
自由女神像	自由女神像 🗽
教堂	教堂 ⛪
清真寺	清真寺 🕌
印度教寺廟	印度教寺廟 🛕
猶太教堂	猶太教堂 🕍
神社	神社 ⛩️
克爾白	克爾白 🕋
噴泉	噴泉 ⛲
帳篷	帳篷 ⛺
多霧	多霧 🌁
星空夜晚	星空夜晚 🌃
城市景觀	城市景觀 🏙️
山中日出	山中日出 🌄
日出	日出 🌅
黃昏城市	黃昏城市 🌆
日落	日落 🌇
夜晚橋	夜晚橋 🌉
溫泉	溫泉 ♨️
旋轉木馬	旋轉木馬 🎠
滑梯	滑梯 🛝
摩天輪	摩天輪 🎡
過山車	過山車 🎢
理髮柱	理髮柱 💈
馬戲團帳篷	馬戲團帳篷 🎪
火車頭	火車頭 🚂
火車車廂	火車車廂 🚃
高速列車	高速列車 🚄
子彈列車	子彈列車 🚅
火車	火車 🚆
地鐵	地鐵 🚇
輕軌	輕軌 🚈
車站	車站 🚉
電車	電車 🚊
單軌列車	單軌列車 🚝
山地火車	山地火車 🚞
電車車廂	電車車廂 🚋
公車	公車 🚌
迎面公車	迎面公車 🚍
無軌電車	無軌電車 🚎
小型巴士	小型巴士 🚐
救護車	救護車 🚑
消防車	消防車 🚒
警車	警車 🚓
迎面警車	迎面警車 🚔
計程車	計程車 🚕
迎面計程車	迎面計程車 🚖
汽車	汽車 🚗
迎面汽車	迎面汽車 🚘
運動型多用途車	運動型多用途車 🚙
皮卡車	皮卡車 🛻
貨車	貨車 🚚
聯結卡車	聯結卡車 🚛
拖拉機	拖拉機 🚜
賽車	賽車 🏎️
摩托車	摩托車 🏍️
機車	機車 🛵
手動輪椅	手動輪椅 🦽
電動輪椅	電動輪椅 🦼
自動人力車	自動人力車 🛺
自行車	自行車 🚲
滑板車	滑板車 🛴
滑板	滑板 🛹
滾軸溜冰鞋	滾軸溜冰鞋 🛼
公車站	公車站 🚏
高速公路	高速公路 🛣️
鐵路軌道	鐵路軌道 🛤️
油桶	油桶 🛢️
加油站	加油站 ⛽
車輪	車輪 🛞
警車燈	警車燈 🚨
水平交通燈	水平交通燈 🚥
垂直交通燈	垂直交通燈 🚦
停車標誌	停車標誌 🛑
施工	施工 🚧
錨	錨 ⚓
救生圈	救生圈 🛟
帆船	帆船 ⛵
獨木舟	獨木舟 🛶
快艇	快艇 🚤
客船	客船 🛳️
渡輪	渡輪 ⛴️
機動船	機動船 🛥️
船	船 🚢
飛機	飛機 ✈️
小型飛機	小型飛機 🛩️
飛機起飛	飛機起飛 🛫
飛機降落	飛機降落 🛬
降落傘	降落傘 🪂
座位	座位 💺
直升機	直升機 🚁
懸掛式鐵路	懸掛式鐵路 🚟
山地纜車	山地纜車 🚠
空中纜車	空中纜車 🚡
衛星	衛星 🛰️
火箭	火箭 🚀
飛碟	飛碟 🛸
服務鈴	服務鈴 🛎️
沙漏完成	沙漏完成 ⌛
沙漏未完成	沙漏未完成 ⏳
手錶	手錶 ⌚
鬧鐘	鬧鐘 ⏰
秒錶	秒錶 ⏱️
計時器	計時器 ⏲️
壁爐時鐘	壁爐時鐘 🕰️
十二點	十二點 🕛
十二點半	十二點半 🕧
一點	一點 🕐
一點半	一點半 🕜
兩點	兩點 🕑
兩點半	兩點半 🕝
三點	三點 🕒
三點半	三點半 🕞
四點	四點 🕓
四點半	四點半 🕟
五點	五點 🕔
五點半	五點半 🕠
六點	六點 🕕
六點半	六點半 🕡
七點	七點 🕖
七點半	七點半 🕢
八點	八點 🕗
八點半	八點半 🕣
九點	九點 🕘
九點半	九點半 🕤
十點	十點 🕙
十點半	十點半 🕥
十一點	十一點 🕚
十一點半	十一點半 🕦
新月	新月 🌑
盈月	盈月 🌒
上弦月	上弦月 🌓
盈凸月	盈凸月 🌔
滿月	滿月 🌕
虧凸月	虧凸月 🌖
下弦月	下弦月 🌗
殘月	殘月 🌘
月牙	月牙 🌙
新月臉	新月臉 🌚
上弦月臉	上弦月臉 🌛
下弦月臉	下弦月臉 🌜
溫度計	溫度計 🌡️
太陽	太陽 ☀️
滿月臉	滿月臉 🌝
太陽臉	太陽臉 🌞
環行星	環行星 🪐
星星	星星 ⭐
發光星星	發光星星 🌟
流星	流星 🌠
銀河	銀河 🌌
雲	雲 ☁️
雲後太陽	雲後太陽 ⛅
雲雨閃電	雲雨閃電 ⛈️
小雲後太陽	小雲後太陽 🌤️
大雲後太陽	大雲後太陽 🌥️
雨雲後太陽	雨雲後太陽 🌦️
雨雲	雨雲 🌧️
雪雲	雪雲 🌨️
閃電雲	閃電雲 🌩️
龍捲風	龍捲風 🌪️
霧	霧 🌫️
風臉	風臉 🌬️
氣旋	氣旋 🌀
彩虹	彩虹 🌈
收傘	收傘 🌂
傘	傘 ☂️
雨傘	雨傘 ☔
地上傘	地上傘 ⛱️
高壓	高壓 ⚡
雪花	雪花 ❄️
雪人	雪人 ☃️
無雪雪人	無雪雪人 ⛄
彗星	彗星 ☄️
火	火 🔥
水滴	水滴 💧
水波	水波 🌊
活動	活動 🎃 🎄 🎆 🎇 🧨 ✨ 🎈 🎉 🎊 🎋 🎍 🎎 🎏 🎐 🎑 🧧 🎀 🎁 🎗️ 🎟️ 🎫
獎章	獎章 🎖️ 🏆 🏅 🥇 🥈 🥉
運動	運動 ⚽ ⚾ 🥎 🏀 🏐 🏈 🏉 🎾 🥏 🎳 🏏 🏑 🏒 🥍 🏓 🏸 🥊 🥋 🥅 ⛳ ⛸️ 🎣 🤿 🎽 🎿 🛷 🥌
遊戲	遊戲 🎯 🪀 🪁 🔫 🎱 🔮 🪄 🎮 🕹️ 🎰 🎲 🧩 🧸 🪅 🪩 🪆 ♠️ ♥️ ♦️ ♣️ ♟️ 🃏 🀄 🎴
藝術	藝術 🎭 🖼️ 🎨 🧵 🪡 🧶 🪢
獸類	獸類 🐵 🐒 🦍 🦧 🐶 🐕 🦮 🐕‍🦺 🐩 🐺 🦊 🦝 🐱 🐈 🐈‍⬛ 🦁 🐯 🐅 🐆 🐴 🫎 🫏 🐎 🦄 🦓 🦌 🦬 🐮 🐂 🐃 🐄 🐷 🐖 🐗 🐽 🐏 🐑 🐐 🐪 🐫 🦙 🦒 🐘 🦣 🦏 🦛 🐭 🐁 🐀 🐹 🐰 🐇 🐿️ 🦫 🦔 🦇 🐻 🐻‍❄️ 🐨 🐼 🦥 🦦 🦨 🦘 🦡 🐾
鳥類	鳥類 🦃 🐔 🐓 🐣 🐤 🐥 🐦 🐧 🕊️ 🦅 🦆 🦢 🦉 🦤 🪶 🦩 🦚 🦜 🪽 🐦‍⬛ 🪿 🐦‍🔥
兩棲	兩棲 🐸
爬行	爬行 🐊 🐢 🦎 🐍 🐲 🐉 🦕 🦖
海洋	海洋 🐳 🐋 🐬 🦭 🐟 🐠 🐡 🦈 🐙 🐚 🪸 🪼 🦀 🦞 🦐 🦑 🦪
昆蟲	昆蟲 🐌 🦋 🐛 🐜 🐝 🪲 🐞 🦗 🪳 🕷️ 🕸️ 🦂 🦟 🪰 🪱 🦠
花卉	花卉 💐 🌸 💮 🪷 🏵️ 🌹 🥀 🌺 🌻 🌼 🌷 🪻
植物	植物 🌱 🪴 🌲 🌳 🌴 🌵 🌾 🌿 ☘️ 🍀 🍁 🍂 🍃 🪹 🪺 🍄 🪾
旗幟	旗幟 🏁 🚩 🎌 🏴 🏳️ 🏳️‍🌈 🏳️‍⚧️ 🏴‍☠️
國旗	國旗 🇦🇨 🇦🇩 🇦🇪 🇦🇫 🇦🇬 🇦🇮 🇦🇱 🇦🇲 🇦🇴 🇦🇶 🇦🇷 🇦🇸 🇦🇹 🇦🇺 🇦🇼 🇦🇽 🇦🇿 🇧🇦 🇧🇧 🇧🇩 🇧🇪 🇧🇫 🇧🇬 🇧🇭 🇧🇮 🇧🇯 🇧🇱 🇧🇲 🇧🇳 🇧🇴 🇧🇶 🇧🇷 🇧🇸 🇧🇹 🇧🇻 🇧🇼 🇧🇾 🇧🇿 🇨🇦 🇨🇨 🇨🇩 🇨🇫 🇨🇬 🇨🇭 🇨🇮 🇨🇰 🇨🇱 🇨🇲 🇨🇳 🇨🇴 🇨🇵 🇨🇶 🇨🇷 🇨🇺 🇨🇻 🇨🇼 🇨🇽 🇨🇾 🇨🇿 🇩🇪 🇩🇬 🇩🇯 🇩🇰 🇩🇲 🇩🇴 🇩🇿 🇪🇦 🇪🇨 🇪🇪 🇪🇬 🇪🇭 🇪🇷 🇪🇸 🇪🇹 🇪🇺 🇫🇮 🇫🇯 🇫🇰 🇫🇲 🇫🇴 🇫🇷 🇬🇦 🇬🇧 🇬🇩 🇬🇪 🇬🇫 🇬🇬 🇬🇭 🇬🇮 🇬🇱 🇬🇲 🇬🇳 🇬🇵 🇬🇶 🇬🇷 🇬🇸 🇬🇹 🇬🇺 🇬🇼 🇬🇾 🇭🇰 🇭🇲 🇭🇳 🇭🇷 🇭🇹 🇭🇺 🇮🇨 🇮🇩 🇮🇪 🇮🇱 🇮🇲 🇮🇳 🇮🇴 🇮🇶 🇮🇷 🇮🇸 🇮🇹 🇯🇪 🇯🇲 🇯🇴 🇯🇵 🇰🇪 🇰🇬 🇰🇭 🇰🇮 🇰🇲 🇰🇳 🇰🇵 🇰🇷 🇰🇼 🇰🇾 🇰🇿 🇱🇦 🇱🇧 🇱🇨 🇱🇮 🇱🇰 🇱🇷 🇱🇸 🇱🇹 🇱🇺 🇱🇻 🇱🇾 🇲🇦 🇲🇨 🇲🇩 🇲🇪 🇲🇫 🇲🇬 🇲🇭 🇲🇰 🇲🇱 🇲🇲 🇲🇳 🇲🇴 🇲🇵 🇲🇶 🇲🇷 🇲🇸 🇲🇹 🇲🇺 🇲🇻 🇲🇼 🇲🇽 🇲🇾 🇲🇿 🇳🇦 🇳🇨 🇳🇪 🇳🇫 🇳🇬 🇳🇮 🇳🇱 🇳🇴 🇳🇵 🇳🇷 🇳🇺 🇳🇿 🇴🇲 🇵🇦 🇵🇪 🇵🇫 🇵🇬 🇵🇭 🇵🇰 🇵🇱 🇵🇲 🇵🇳 🇵🇷 🇵🇸 🇵🇹 🇵🇼 🇵🇾 🇶🇦 🇷🇪 🇷🇴 🇷🇸 🇷🇺 🇷🇼 🇸🇦 🇸🇧 🇸🇨 🇸🇩 🇸🇪 🇸🇬 🇸🇭 🇸🇮 🇸🇯 🇸🇰 🇸🇱 🇸🇲 🇸🇳 🇸🇴 🇸🇷 🇸🇸 🇸🇹 🇸🇻 🇸🇽 🇸🇾 🇸🇿 🇹🇦 🇹🇨 🇹🇩 🇹🇫 🇹🇬 🇹🇭 🇹🇯 🇹🇰 🇹🇱 🇹🇲 🇹🇳 🇹🇴 🇹🇷 🇹🇹 🇹🇻 🇹🇼 🇹🇿 🇺🇦 🇺🇬 🇺🇲 🇺🇳 🇺🇸 🇺🇾 🇺🇿 🇻🇦 🇻🇨 🇻🇪 🇻🇬 🇻🇮 🇻🇳 🇻🇺 🇼🇫 🇼🇸 🇽🇰 🇾🇪 🇾🇹 🇿🇦 🇿🇲 🇿🇼
區旗	區旗 🏴󠁧󠁢󠁥󠁮󠁧󠁿 🏴󠁧󠁢󠁳󠁣󠁴󠁿 🏴󠁧󠁢󠁷󠁬󠁳󠁿
水果	水果 🍇 🍈 🍉 🍊 🍋 🍋‍🟩 🍌 🍍 🥭 🍎 🍏 🍐 🍑 🍒 🍓 🫐 🥝 🍅 🫒 🥥
蔬菜	蔬菜 🥑 🍆 🥔 🥕 🌽 🌶️ 🫑 🥒 🥬 🥦 🧄 🧅 🥜 🫘 🌰 🫚 🫛 🍄‍🟫 🫜
熟食	熟食 🍞 🥐 🥖 🫓 🥨 🥯 🥞 🧇 🧀 🍖 🍗 🥩 🥓 🍔 🍟 🍕 🌭 🥪 🌮 🌯 🫔 🥙 🧆 🥚 🍳 🥘 🍲 🫕 🥣 🥗 🍿 🧈 🧂 🥫
亞洲美食	亞洲美食 🍱 🍘 🍙 🍚 🍛 🍜 🍝 🍠 🍢 🍣 🍤 🍥 🥮 🍡 🥟 🥠 🥡
甜食	甜食 🍦 🍧 🍨 🍩 🍪 🎂 🍰 🧁 🥧 🍫 🍬 🍭 🍮 🍯
飲料	飲料 🍼 🥛 ☕ 🫖 🍵 🍶 🍾 🍷 🍸 🍹 🍺 🍻 🥂 🥃 🫗 🥤 🧋 🧃 🧉 🧊
餐具	餐具 🥢 🍽️ 🍴 🥄 🔪 🫙 🏺
衣服	衣服 👓 🕶️ 🥽 🥼 🦺 👔 👕 👖 🧣 🧤 🧥 🧦 👗 👘 🥻 🩱 🩲 🩳 👙 👚 🪭 👛 👜 👝 🛍️ 🎒 🩴 👞 👟 🥾 🥿 👠 👡 🩰 👢 🪮 👑 👒 🎩 🎓 🧢 🪖 ⛑️ 📿 💄 💍 💎
聲音	聲音 🔇 🔈 🔉 🔊 📢 📣 📯 🔔 🔕
音樂	音樂 🎼 🎵 🎶 🎙️ 🎚️ 🎛️ 🎤 🎧 📻
樂器	樂器 🎷 🪗 🎸 🎹 🎺 🎻 🪕 🥁 🪘 🪇 🪈 🪉
電話	電話 📱 📲 ☎️ 📞 📟 📠
電腦	電腦 🔋 🪫 🔌 💻 🖥️ 🖨️ ⌨️ 🖱️ 🖲️ 💽 💾 💿 📀 🧮
光影	光影 🎥 🎞️ 📽️ 🎬 📺 📷 📸 📹 📼 🔍 🔎 🕯️ 💡 🔦 🏮 🪔
書紙	書紙 📔 📕 📖 📗 📘 📙 📚 📓 📒 📃 📜 📄 📰 🗞️ 📑 🔖 🏷️
金錢	金錢 💰 🪙 💴 💵 💶 💷 💸 💳 🧾 💹
郵件	郵件 ✉️ 📧 📨 📩 📤 📥 📦 📫 📪 📬 📭 📮 🗳️
書寫	書寫 ✏️ ✒️ 🖋️ 🖊️ 🖌️ 🖍️ 📝
辦公	辦公 💼 📁 📂 🗂️ 📅 📆 🗒️ 🗓️ 📇 📈 📉 📊 📋 📌 📍 📎 🖇️ 📏 📐 ✂️ 🗃️ 🗄️ 🗑️
鎖	鎖 🔒 🔓 🔏 🔐 🔑 🗝️
工具	工具 🔨 🪓 ⛏️ ⚒️ 🛠️ 🗡️ ⚔️ 💣 🪃 🏹 🛡️ 🪚 🔧 🪛 🔩 ⚙️ 🗜️ ⚖️ 🦯 🔗 ⛓️‍💥 ⛓️ 🪝 🧰 🧲 🪜 🪏
科學	科學 ⚗️ 🧪 🧫 🧬 🔬 🔭 📡
家居	家居 🚪 🛗 🪞 🪟 🛏️ 🛋️ 🪑 🚽 🪠 🚿 🛁 🪤 🪒 🧴 🧷 🧹 🧺 🧻 🪣 🧼 🫧 🪥 🧽 🧯 🛒
其他物品	其他物品 🚬 ⚰️ 🪦 ⚱️ 🧿 🪬 🗿 🪧 🪪
握拳	握拳 👍 👎 ✊ 👊 🤛 🤜
雙手	雙手 👏 🙌 🫶 👐 🤲 🤝 🙏
手持物	手持物 ✍️ 💅 🤳
愛意	愛意 🥰 😍 🤩 😘 😗 ☺️ 😚 😙 🥲
舌頭	舌頭 😋 😛 😜 🤪 😝 🤑
手臉	手臉 🤗 🤭 🫢 🫣 🤫 🤔 🫡
中性	中性 🤐 🤨 😐 😑 😶 🫥 😶‍🌫️ 😏 😒 🙄 😬 😮‍💨 🤥 🫨 🙂‍↔️ 🙂‍↕️
睡臉	睡臉 😌 😔 😪 🤤 😴 🫩
不適	不適 😷 🤒 🤕 🤢 🤮 🤧 🥵 🥶 🥴 😵 😵‍💫 🤯
帽臉	帽臉 🤠 🥳 🥸
擔憂	擔憂 😕 🫤 😟 🙁 ☹️ 😮 😯 😲 😳 🥺 🥹 😦 😧 😨 😰 😥 😢 😭 😱 😖 😣 😞 😓 😩 😫 🥱
負面	負面 😤 😡 😠 🤬 😈 👿 💀 ☠️
裝扮	裝扮 💩 🤡 👹 👺 👻 👽 👾 🤖
心	心 💌 💘 💝 💖 💗 💓 💞 💕 💟 ❣️ 💔 ❤️‍🔥 ❤️‍🩹 ❤️ 🩷 🧡 💛 💚 💙 🩵 💜 🤎 🖤 🩶 🤍
情感	情感 💋 💯 💢 💥 💫 💦 💨 🕳️ 💬 👁️‍🗨️ 🗨️ 🗯️ 💭 💤
交通標誌	交通標誌 🏧 🚮 🚰 ♿ 🚹 🚺 🚻 🚼 🚾 🛂 🛃 🛄 🛅
箭頭	箭頭 ⬆️ ↗️ ➡️ ↘️ ⬇️ ↙️ ⬅️ ↖️ ↕️ ↔️ ↩️ ↪️ ⤴️ ⤵️ 🔃 🔄 🔙 🔚 🔛 🔜 🔝
宗教	宗教 🛐 ⚛️ 🕉️ ✡️ ☸️ ☯️ ✝️ ☦️ ☪️ ☮️ 🕎 🔯 🪯 ⛪ 🕌 🛕 🕍 ⛩️ 🕋
星座	星座 ♈ ♉ ♊ ♋ ♌ ♍ ♎ ♏ ♐ ♑ ♒ ♓ ⛎
媒體符號	媒體符號 🔀 🔁 🔂 ▶️ ⏩ ⏭️ ⏯️ ◀️ ⏪ ⏮️ 🔼 ⏫ 🔽 ⏬ ⏸️ ⏹️ ⏺️ ⏏️ 🎦 🔅 🔆 📶 🛜 📳 📴
性別	性別 ♀️ ♂️ ⚧️
數學	數學 ✖️ ➕ ➖ ➗ 🟰 ♾️
標點	標點 ‼️ ⁉️ ❓ ❔ ❕ ❗ 〰️
貨幣	貨幣 💱 💲
其他符號	其他符號 ⚕️ ♻️ ⚜️ 🔱 📛 🔰 ⭕ ✅ ☑️ ✔️ ❌ ❎ ➰ ➿ 〽️ ✳️ ✴️ ❇️ ©️ ®️ ™️ 🫟
按鍵帽	按鍵帽 #️⃣ *️⃣ 0️⃣ 1️⃣ 2️⃣ 3️⃣ 4️⃣ 5️⃣ 6️⃣ 7️⃣ 8️⃣ 9️⃣ 🔟
字母數字	字母數字 🔠 🔡 🔢 🔣 🔤 🅰️ 🆎 🅱️ 🆑 🆒 🆓 ℹ️ 🆔 Ⓜ️ 🆕 🆖 🅾️ 🆗 🅿️ 🆘 🆙 🆚 🈁 🈂️ 🈷️ 🈶 🈯 🉐 🈹 🈚 🈲 🉑 🈸 🈴 🈳 ㊗️ ㊙️ 🈺 🈵
幾何	幾何 🔴 🟠 🟡 🟢 🔵 🟣 🟤 ⚫ ⚪ 🟥 🟧 🟨 🟩 🟦 🟪 🟫 ⬛ ⬜ ◼️ ◻️ ◾ ◽ ▪️ ▫️ 🔶 🔷 🔸 🔹 🔺 🔻 💠 🔘 🔳 🔲
地圖	地圖 🌍 🌎 🌏 🌐 🗺️ 🗾 🧭
地理	地理 🏔️ ⛰️ 🌋 🗻 🏕️ 🏖️ 🏜️ 🏝️ 🏞️
建築	建築 🏟️ 🏛️ 🏗️ 🧱 🪨 🪵 🛖 🏘️ 🏚️ 🏠 🏡 🏢 🏣 🏤 🏥 🏦 🏨 🏩 🏪 🏫 🏬 🏭 🏯 🏰 💒 🗼 🗽
其他	其他 ⛲ ⛺ 🌁 🌃 🏙️ 🌄 🌅 🌆 🌇 🌉 ♨️ 🎠 🛝 🎡 🎢 💈 🎪
陸地交通	陸地交通 🚂 🚃 🚄 🚅 🚆 🚇 🚈 🚉 🚊 🚝 🚞 🚋 🚌 🚍 🚎 🚐 🚑 🚒 🚓 🚔 🚕 🚖 🚗 🚘 🚙 🛻 🚚 🚛 🚜 🏎️ 🏍️ 🛵 🦽 🦼 🛺 🚲 🛴 🛹 🛼 🚏 🛣️ 🛤️ 🛢️ ⛽ 🛞 🚨 🚥 🚦 🛑 🚧
水上交通	水上交通 ⚓ 🛟 ⛵ 🛶 🚤 🛳️ ⛴️ 🛥️ 🚢
空中交通	空中交通 ✈️ 🛩️ 🛫 🛬 🪂 💺 🚁 🚟 🚠 🚡 🛰️ 🚀 🛸
時間	時間 ⌛ ⏳ ⌚ ⏰ ⏱️ ⏲️ 🕰️ 🕛 🕧 🕐 🕜 🕑 🕝 🕒 🕞 🕓 🕟 🕔 🕠 🕕 🕡 🕖 🕢 🕗 🕣 🕘 🕤 🕙 🕥 🕚 🕦
天空與天氣	天空與天氣 🌑 🌒 🌓 🌔 🌕 🌖 🌗 🌘 🌙 🌚 🌛 🌜 🌡️ ☀️ 🌝 🌞 🪐 ⭐ 🌟 🌠 🌌 ☁️ ⛅ ⛈️ 🌤️ 🌥️ 🌦️ 🌧️ 🌨️ 🌩️ 🌪️ 🌫️ 🌬️ 🌀 🌈 🌂 ☂️ ☔ ⛱️ ⚡ ❄️ ☃️ ⛄ ☄️ 🔥 💧 🌊
爛	爛 👎
寫	寫 ✍️
上	上 ⬆️
右	右 ➡️
下	下 ⬇️
左	左 ⬅️
左轉	左轉 ↩️
右轉	右轉 ↪️
上彎	上彎 ⤴️
下彎	下彎 ⤵️
上下轉	上下轉 🔃
旋轉	旋轉 🔄
啟用	啟用 🔛
很快	很快 🔜
錯誤	錯誤 ❌
失敗	失敗 💥
注意	注意 📢
資訊	資訊 ℹ️
成功	成功 ✅
通過	通過 ☑️
確認	確認 ✔️
疑問	疑問 ❓
進行中	進行中 🔄
等待	等待 ⌛
完成	完成 🏁
回傳	回傳 🔙
開始	開始 🟢
重試	重試 🔁
重啟	重啟 🔄
記錄	記錄 📝
運行	運行 ▶️
中止	中止 🛑
部署	部署 🚀
計時	計時 ⏱️
設置	設置 ⚙️
除錯	除錯 🐞
備註	備註 💬
標記	標記 📌
追蹤	追蹤 📍
搜尋	搜尋 🔍
測試	測試 🧪
通訊	通訊 📨
更新	更新 🔃
同步	同步 🔄
分支	分支 🌿
合併	合併 🔀
版本	版本 🧾
密鑰	密鑰 🔑
授權	授權 🛡️
風險	風險 ☢️
驗證	驗證 🔐
數據	數據 📊
圖表	圖表 📊
趨勢	趨勢 📈
資料庫	資料庫 🗄️
儲存	儲存 💾
接口	接口 🔌
抽象	抽象 🧩
實作	實作 🛠️
類別	類別 🧱
實例	實例 🧍
服務	服務 🛎️
模組	模組 📦
檢查器	檢查器 🧐
邏輯	邏輯 ♻️
流程	流程 🔁
資源	資源 📚
中介層	中介層 🪟
任務	任務 📋
指令	指令 📜
依賴	依賴 🧷
配置	配置 🧰
記憶體	記憶體 🧠