表演	表演 🎭
戲劇	戲劇 🎭 🤡
面具	面具 🎭
戲	戲 🎭
藝	藝 🎭
畫框	畫框 🖼️
畫作	畫作 🖼️
圖	圖 🖼️
畫	畫 🖼️
展	展 🖼️
調色盤	調色盤 🎨
顏料盤	顏料盤 🎨
畫畫	畫畫 🎨
色盤	色盤 🎨
畫具	畫具 🎨
彩	彩 🎨
線	線 🧵
縫線	縫線 🧵
細線	細線 🧵
織	織 🧵
線團	線團 🧵 🧶
縫針	縫針 🪡
針	針 🪡 💉 📌
縫	縫 🪡
細針	細針 🪡
針線	針線 🪡
毛線	毛線 🧶
毛衣線	毛衣線 🧶
毛球	毛球 🧶
編織	編織 🧶
結	結 🪢
繩結	繩結 🪢
打結	打結 🪢
打繩	打繩 🪢
纏	纏 🪢
勳章	勳章 🎖️ 🏆 🏅 🥇 🥈 🥉
獎章	獎章 🎖️ 🏅 🏆 🥇 🥈 🥉
榮譽章	榮譽章 🎖️
獎	獎 🎖️
勛	勛 🎖️
獎盃	獎盃 🏆
冠軍盃	冠軍盃 🏆
獎品	獎品 🏆
冠盃	冠盃 🏆
杯	杯 🏆 🍵
獎牌	獎牌 🏅 🎖️ 🏆 🥇 🥈 🥉
運動獎牌	運動獎牌 🏅
金牌	金牌 🏅 🥇
運動	運動 🏅 ⚽ ⚾ 🥎 🏀 🏐 🏈 🏉 🎾 🥏 🎳 🏏 🏑 🏒 🥍 🏓 🏸 🥊 🥋 🥅 ⛳ ⛸️ 🎣 🤿 🎽 🎿 🛷 🥌 🤺 🏇 ⛷️ 🏂 🏌️ 🏄 🚣 🏊 ⛹️ 🏋️ 🚴 🚵 🤸 🤼 🤽 🤾 🤹 🏃‍♂️ 🧘 🏃 🧘‍♂️
冠軍	冠軍 🥇
第一名	第一名 🥇
一名	一名 🥇
金	金 🥇
銀牌	銀牌 🥈
第二名	第二名 🥈
亞軍	亞軍 🥈
二名	二名 🥈
銀	銀 🥈
銅牌	銅牌 🥉
第三名	第三名 🥉
季軍	季軍 🥉
三名	三名 🥉
銅	銅 🥉
南瓜燈	南瓜燈 🎃
萬聖節	萬聖節 🎃 👻 🕸️
南瓜	南瓜 🎃
燈籠	燈籠 🎃 🏮
燈	燈 🎃 💡
聖誕樹	聖誕樹 🎄
聖誕	聖誕 🎄 🇨🇽
樹	樹 🎄 🎋 🌱 🪴 🌲 🌳 🌴 🌵 🌾 🌿 ☘️ 🍀 🍁 🍂 🍃 🪹 🪺 🍄 🪾
裝飾	裝飾 🎄 ⚜️ 〰️
節樹	節樹 🎄
煙火	煙火 🎆
煙花	煙花 🎆
煙火秀	煙火秀 🎆
爆	爆 🎆 🧨
光	光 🎆 💿
火花棒	火花棒 🎇
煙火棒	煙火棒 🎇
手持煙花	手持煙花 🎇
火棒	火棒 🎇
棒	棒 🎇 🪄
鞭炮	鞭炮 🧨
爆竹	爆竹 🧨
爆竹聲	爆竹聲 🧨
炮	炮 🧨 🎉
星光	星光 ✨ 🌃 ⭐
閃光	閃光 ✨ ❇️
閃耀	閃耀 ✨
光芒	光芒 ✨ ❇️
星	星 ✨
氣球	氣球 🎈
派對球	派對球 🎈 🎊
飄氣球	飄氣球 🎈
彩球	彩球 🎈 🎊
球	球 🎈 🎊 🪀 🎱 🔮 ⚽ ⚾ 🥎 🏀 🏐 🏈 🏉 🎾 🎳 🏏 🏑 🏒 🥍 🏓 🏸 ⛳
派對炮	派對炮 🎉
彩帶炮	彩帶炮 🎉
爆炮	爆炮 🎉
慶炮	慶炮 🎉
彩帶球	彩帶球 🎊
慶球	慶球 🎊
七夕	七夕 🎋
許願	許願 🎋
願	願 🎋
樹飾	樹飾 🎋
松飾	松飾 🎍
松	松 🎍 🌲
新年松	新年松 🎍
日松	日松 🎍
飾	飾 🎍
雛人偶	雛人偶 🎎
日本偶	日本偶 🎎
娃偶	娃偶 🎎
雛	雛 🎎 🐣
娃	娃 🎎
鯉魚旗	鯉魚旗 🎏
魚旗	魚旗 🎏
兒童節	兒童節 🎏
日旗	日旗 🎏
魚	魚 🎏 🎣 🐟
風鈴	風鈴 🎐
清涼鈴	清涼鈴 🎐
日本鈴	日本鈴 🎐
夏鈴	夏鈴 🎐
鈴	鈴 🎐 🔔
賞月	賞月 🎑
中秋	中秋 🎑 🥮 🌕 🏮
月亮	月亮 🎑 ☪️ 🌑 🌓 🌔 🌖 🌗 🌙 🌛
月	月 🎑 🥮
月祭	月祭 🎑
紅包	紅包 🧧
壓歲錢	壓歲錢 🧧
紅信封	紅信封 🧧
包	包 🧧 🎁 👜 📦
禮金	禮金 🧧
緞帶	緞帶 🎀
彩帶	彩帶 🎀
禮帶	禮帶 🎀
飾帶	飾帶 🎀
帶	帶 🎀
禮物	禮物 🎁 🎀 🛍️
禮品	禮品 🎁
包裝盒	包裝盒 🎁
禮盒	禮盒 🎁
紀念帶	紀念帶 🎗️
黃絲帶	黃絲帶 🎗️
緬懷	緬懷 🎗️
勳帶	勳帶 🎗️
絲帶	絲帶 🎗️
入場券	入場券 🎟️
門票	門票 🎟️ 🎫
票	票 🎟️ 🎫
券	券 🎟️
活動票	活動票 🎟️
票券	票券 🎫
入場票	入場票 🎫
參加券	參加券 🎫
飛鏢	飛鏢 🎯
靶心	靶心 🎯
射擊	射擊 🎯
靶	靶 🎯
鏢	鏢 🎯 🪃
溜溜球	溜溜球 🪀
懸球	懸球 🪀
玩球	玩球 🪀
風箏	風箏 🪁
放風箏	放風箏 🪁
飛箏	飛箏 🪁
箏	箏 🪁
飛	飛 🪁 🥏
水槍	水槍 🔫
玩具槍	玩具槍 🔫
射水	射水 🔫
槍	槍 🔫
射	射 🔫
撞球	撞球 🎱
八號球	八號球 🎱
桌球	桌球 🎱 🏓
桌	桌 🎱
水晶球	水晶球 🔮
預言	預言 🔮
魔法球	魔法球 🔮
占	占 🔮
魔杖	魔杖 🪄
魔法棒	魔法棒 🪄
魔術	魔術 🪄
杖	杖 🪄 🩼
遊戲機	遊戲機 🎮
電玩	電玩 🎮 👾
控制器	控制器 🎮 🧃
遊戲	遊戲 🎮 🎯 🪀 🪁 🔫 🎱 🔮 🪄 🕹️ 🎰 🎲 🧩 🧸 🪅 🪩 🪆 ♠️ ♥️ ♦️ ♣️ ♟️ 🃏 🀄 🎴
電	電 🎮 🔋
搖桿	搖桿 🕹️
控制桿	控制桿 🕹️
遊戲桿	遊戲桿 🕹️
桿	桿 🕹️
控	控 🕹️
老虎機	老虎機 🎰
賭博機	賭博機 🎰
投幣機	投幣機 🎰
賭機	賭機 🎰
幣	幣 🎰
骰子	骰子 🎲
桌遊	桌遊 🎲
骰	骰 🎲
擲骰	擲骰 🎲
拼圖	拼圖 🧩
拼塊	拼塊 🧩
拼	拼 🧩
益智圖	益智圖 🧩
塊	塊 🧩 ♦️
泰迪熊	泰迪熊 🧸
玩具熊	玩具熊 🧸
熊	熊 🧸 🐻
絨熊	絨熊 🧸
玩熊	玩熊 🧸
彩罐	彩罐 🪅
派對罐	派對罐 🪅
節慶罐	節慶罐 🪅
罐	罐 🪅 🫙 🥫
掛罐	掛罐 🪅
鏡球	鏡球 🪩
舞會球	舞會球 🪩
反光球	反光球 🪩
舞球	舞球 🪩
光球	光球 🪩
套娃	套娃 🪆
娃娃	娃娃 🪆
木偶	木偶 🪆
套娃娃	套娃娃 🪆
俄娃	俄娃 🪆
黑桃	黑桃 ♠️
撲克牌	撲克牌 ♠️ ♥️ ♦️ ♣️ 🃏
黑A	黑A ♠️
♠️	♠️ ♠️
桃	桃 ♠️ 🍑
紅心	紅心 ♥️ ❤️
紅A	紅A ♥️
♥️	♥️ ♥️
心	心 ♥️ 🫀 💌 💘 💝 💖 💗 💓 💞 💕 💟 ❣️ 💔 ❤️‍🔥 ❤️‍🩹 ❤️ 🩷 🧡 💛 💚 💙 🩵 💜 🤎 🖤 🩶 🤍
方塊	方塊 ♦️
方A	方A ♦️
♦️	♦️ ♦️
梅花	梅花 ♣️
梅A	梅A ♣️
♣️	♣️ ♣️
花	花 ♣️ 🎴 💐 🌼 🌸 💮 🪷 🏵️ 🌹 🥀 🌺 🌻 🌷 🪻
棋子	棋子 ♟️
國際象棋	國際象棋 ♟️
棋	棋 ♟️
棋卒	棋卒 ♟️
卒	卒 ♟️
小丑	小丑 🃏 🤡 💩 👹 👺 👻 👽 👾 🤖
小丑牌	小丑牌 🃏
丑	丑 🃏
牌	牌 🃏 🎴
麻將	麻將 🀄
紅中	紅中 🀄
麻	麻 🀄
紅	紅 🀄 💄
🀄	🀄 🀄
花牌	花牌 🎴
日本花牌	日本花牌 🎴
卡牌	卡牌 🎴
足球	足球 ⚽
踢	踢 ⚽
足	足 ⚽ 🦶
棒球	棒球 ⚾
擊	擊 ⚾ 🥊
打棒	打棒 ⚾
壘球	壘球 🥎
擲	擲 🥎 🥏
壘	壘 🥎
籃球	籃球 🏀 ⛹️
投	投 🏀
籃	籃 🏀
排球	排球 🏐
扣	扣 🏐
排	排 🏐 🥩
美式足球	美式足球 🏈
橄欖球	橄欖球 🏈 🏉
美足	美足 🏈
擲球	擲球 🏉
橄欖	橄欖 🏉 🫒
網球	網球 🎾
揮	揮 🎾
拍	拍 🎾 🏓 🏸
網	網 🎾 🥅 🕸️
飛盤	飛盤 🥏
投盤	投盤 🥏
圓盤	圓盤 🥏
保齡球	保齡球 🎳
滾球	滾球 🎳 🖲️
保	保 🎳
板球	板球 🏏
擊球	擊球 🏏
板	板 🏏 🍥
曲棍球	曲棍球 🏑
曲	曲 🏑
棍	棍 🏑 🥍
冰球	冰球 🏒 🧊 🍨
冰	冰 🏒 🧊 🍧 🍨
棍球	棍球 🏒
長曲棍球	長曲棍球 🥍
長曲	長曲 🥍
乒乓球	乒乓球 🏓
羽毛球	羽毛球 🏸
羽球	羽球 🏸
羽	羽 🏸 🪶
拳擊	拳擊 🥊
拳	拳 🥊
手套	手套 🥊 🧤
拳套	拳套 🥊
武術	武術 🥋
空手道	空手道 🥋
武術服	武術服 🥋
武	武 🥋
球門	球門 🥅
門	門 🥅 🚪
守門	守門 🥅
高爾夫	高爾夫 ⛳ 🏌️
洞	洞 ⛳ 🕳️
推桿	推桿 ⛳
溜冰	溜冰 ⛸️
冰鞋	冰鞋 ⛸️
滑冰	滑冰 ⛸️
滑	滑 ⛸️ 🎿
釣魚	釣魚 🎣
釣	釣 🎣
竿	竿 🎣
潛水	潛水 🤿
潛	潛 🤿
水下	水下 🤿
面罩	面罩 🤿
跑步	跑步 🎽 🏃
運動衣	運動衣 🎽
跑	跑 🎽
衣	衣 🎽 👚
滑雪	滑雪 🎿 ⛷️ 🏂
雪板	雪板 🎿 🏂
雪	雪 🎿
雪橇	雪橇 🛷
冰橇	冰橇 🛷
滑橇	滑橇 🛷
橇	橇 🛷
冰壺	冰壺 🥌
壺	壺 🥌 🏺 🫖
冰運	冰運 🥌
壺賽	壺賽 🥌
青蛙	青蛙 🐸
小蛙	小蛙 🐸
水蛙	水蛙 🐸
蛙	蛙 🐸
蛙仔	蛙仔 🐸
火雞	火雞 🦃
大火雞	大火雞 🦃
家禽	家禽 🦃 🐔
火	火 🦃 🔥
雞	雞 🦃 🐔 🐓 🍗
小雞	小雞 🐔 🐣 🐤
母雞	母雞 🐔
雞隻	雞隻 🐔
公雞	公雞 🐓
雄雞	雄雞 🐓
鳴雞	鳴雞 🐓
公	公 🐓
雛雞	雛雞 🐣 🐤
雞蛋	雞蛋 🐣 🥚
孵蛋	孵蛋 🐣
黃雞	黃雞 🐤
雞仔	雞仔 🐤
雞寶	雞寶 🐤
小雞臉	小雞臉 🐥
雛雞臉	雛雞臉 🐥
黃雞臉	黃雞臉 🐥
雞臉	雞臉 🐥
臉	臉 🐥
鳥	鳥 🐦
小鳥	小鳥 🐦
飛鳥	飛鳥 🐦
鳥兒	鳥兒 🐦
鳥類	鳥類 🐦 🦃 🐔 🐓 🐣 🐤 🐥 🐧 🕊️ 🦅 🦆 🦢 🦉 🦤 🪶 🦩 🦚 🦜 🪽 🐦‍⬛ 🪿 🐦‍🔥
企鵝	企鵝 🐧
小企鵝	小企鵝 🐧
南極鳥	南極鳥 🐧
鵝	鵝 🐧 🦢 🪿
企	企 🐧
鴿	鴿 🕊️
白鴿	白鴿 🕊️
和平	和平 🕊️ 💙 ☮️
鴿子	鴿子 🕊️
和	和 🕊️
鷹	鷹 🦅
大鷹	大鷹 🦅
老鷹	老鷹 🦅
猛禽	猛禽 🦅
鷹鳥	鷹鳥 🦅
鴨	鴨 🦆
小鴨	小鴨 🦆
家鴨	家鴨 🦆
鴨子	鴨子 🦆
鴨鴨	鴨鴨 🦆
天鵝	天鵝 🦢
白天鵝	白天鵝 🦢
水鳥	水鳥 🦢
優雅鳥	優雅鳥 🦢
貓頭鷹	貓頭鷹 🦉
夜鷹	夜鷹 🦉
智慧鳥	智慧鳥 🦉
夜鳥	夜鳥 🦉
貓鷹	貓鷹 🦉
渡渡鳥	渡渡鳥 🦤
滅絕鳥	滅絕鳥 🦤
大鳥	大鳥 🦤
古鳥	古鳥 🦤
渡	渡 🦤
羽毛	羽毛 🪶
鳥毛	鳥毛 🪶
飛毛	飛毛 🪶
羽片	羽片 🪶
火烈鳥	火烈鳥 🦩
紅鳥	紅鳥 🦩
長腿鳥	長腿鳥 🦩
粉鳥	粉鳥 🦩
烈	烈 🦩
孔雀	孔雀 🦚
開屏鳥	開屏鳥 🦚
美麗鳥	美麗鳥 🦚
開屏	開屏 🦚
孔	孔 🦚
鸚鵡	鸚鵡 🦜
說話鳥	說話鳥 🦜
彩色鳥	彩色鳥 🦜
鵡	鵡 🦜
說鳥	說鳥 🦜
翅膀	翅膀 🪽
飛翼	飛翼 🪽
鳥翼	鳥翼 🪽
翼	翼 🪽
翅	翅 🪽
黑鳥	黑鳥 🐦‍⬛
黑色鳥	黑色鳥 🐦‍⬛
烏鴉	烏鴉 🐦‍⬛
鴉	鴉 🐦‍⬛
黑	黑 🐦‍⬛
大鵝	大鵝 🪿
家鵝	家鵝 🪿
水鵝	水鵝 🪿
鵝隻	鵝隻 🪿
鳳凰	鳳凰 🐦‍🔥
火鳥	火鳥 🐦‍🔥
神鳥	神鳥 🐦‍🔥
鳳	鳳 🐦‍🔥
蝸牛	蝸牛 🐌
蝸	蝸 🐌
牛	牛 🐌 🐮 🐂 🐃
緩	緩 🐌
牛殼	牛殼 🐌
蝴蝶	蝴蝶 🦋
蝶	蝶 🦋
彩蝶	彩蝶 🦋
飛蝶	飛蝶 🦋
美蝶	美蝶 🦋
小蟲	小蟲 🐛 🐌 🦋 🐜 🐝 🪲 🐞 🦗 🪳 🕷️ 🕸️ 🦂 🦟 🪰 🪱 🦠
毛蟲	毛蟲 🐛
蟲	蟲 🐛
幼蟲	幼蟲 🐛
螞蟻	螞蟻 🐜
蟻	蟻 🐜
工蟻	工蟻 🐜
蟲族	蟲族 🐜
蜜蜂	蜜蜂 🐝
蜂	蜂 🐝
採蜜	採蜜 🐝
蜂群	蜂群 🐝
甲蟲	甲蟲 🪲
甲	甲 🪲
昆蟲	昆蟲 🪲 🐌 🦋 🐛 🐜 🐝 🐞 🦗 🪳 🕷️ 🕸️ 🦂 🦟 🪰 🪱 🦠
硬殼蟲	硬殼蟲 🪲
瓢蟲	瓢蟲 🐞
小瓢	小瓢 🐞
紅點蟲	紅點蟲 🐞
瓢	瓢 🐞
蟋蟀	蟋蟀 🦗
蟀	蟀 🦗
鳴蟲	鳴蟲 🦗
跳蟲	跳蟲 🦗
蟑螂	蟑螂 🪳
蟑	蟑 🪳
噁蟲	噁蟲 🪳
螂	螂 🪳
家害	家害 🪳
蜘蛛	蜘蛛 🕷️
蛛	蛛 🕷️
網蟲	網蟲 🕷️
八腳	八腳 🕷️ 🐙
蜘蛛網	蜘蛛網 🕸️
蛛網	蛛網 🕸️
絲	絲 🕸️
網子	網子 🕸️
蠍子	蠍子 🦂
蠍	蠍 🦂
毒尾	毒尾 🦂
毒蟲	毒蟲 🦂
蚊子	蚊子 🦟
蚊	蚊 🦟
吸血蟲	吸血蟲 🦟
飛蟲	飛蟲 🦟 🪰
蒼蠅	蒼蠅 🪰
蠅	蠅 🪰
髒蟲	髒蟲 🪰
蠕蟲	蠕蟲 🪱
蠕	蠕 🪱
線蟲	線蟲 🪱
地蟲	地蟲 🪱
微生物	微生物 🦠
微	微 🦠
病原	病原 🦠
細菌	細菌 🦠
病菌	病菌 🦠
猴	猴 🐵 🐒
臉猴	臉猴 🐵
猴臉	猴臉 🐵 🙈 🙉 🙊
猴子	猴子 🐵 🐒
靈長	靈長 🐵 🐒
靈長類	靈長類 🐒
猿	猿 🐒 🦧
猩猩	猩猩 🦍 🦧
大猩	大猩 🦍
猩	猩 🦍
猿人	猿人 🦍
力士	力士 🦍
紅猩	紅猩 🦧
紅毛	紅毛 🦧
靈猿	靈猿 🦧
狗	狗 🐶 🐕
狗臉	狗臉 🐶
小狗	小狗 🐶 🐕
狗頭	狗頭 🐶
臉狗	臉狗 🐶
犬	犬 🐕
狗狗	狗狗 🐕
導盲犬	導盲犬 🦮
導盲	導盲 🦮 🧑‍🦯
幫狗	幫狗 🦮
領犬	領犬 🦮
服務犬	服務犬 🐕‍🦺
工作犬	工作犬 🐕‍🦺
幫助犬	幫助犬 🐕‍🦺
輔助犬	輔助犬 🐕‍🦺
貴賓犬	貴賓犬 🐩
貴賓	貴賓 🐩
卷毛狗	卷毛狗 🐩
美犬	美犬 🐩
狼	狼 🐺
野狼	野狼 🐺
灰狼	灰狼 🐺
狼犬	狼犬 🐺
狐	狐 🦊
狐狸	狐狸 🦊
小狐	小狐 🦊
紅狐	紅狐 🦊
狡狐	狡狐 🦊
浣熊	浣熊 🦝
小浣	小浣 🦝
洗熊	洗熊 🦝
熊臉	熊臉 🦝
貓	貓 🐱 🐈
貓臉	貓臉 🐱 😺 😸 😹 😻 😼 😽 🙀 😿 😾
小貓	小貓 🐱 🐈
臉貓	臉貓 🐱
家貓	家貓 🐈
貓咪	貓咪 🐈
黑貓	黑貓 🐈‍⬛
小黑	小黑 🐈‍⬛
黑色貓	黑色貓 🐈‍⬛
暗貓	暗貓 🐈‍⬛
獅	獅 🦁
獅子	獅子 🦁
森林王	森林王 🦁
王者	王者 🦁
虎	虎 🐯 🐅
臉虎	臉虎 🐯
虎臉	虎臉 🐯
老虎	老虎 🐯 🐅
猛虎	猛虎 🐅
大貓	大貓 🐅
豹	豹 🐆 🦭
獵豹	獵豹 🐆
斑豹	斑豹 🐆
豹紋	豹紋 🐆
馬	馬 🐴 🐎
馬臉	馬臉 🐴
臉馬	臉馬 🐴
小馬	小馬 🐴 🐎
麋鹿	麋鹿 🫎 🦌
大鹿	大鹿 🫎
長角鹿	長角鹿 🫎
北鹿	北鹿 🫎
驢	驢 🫏
小驢	小驢 🫏
驢子	驢子 🫏
驢獸	驢獸 🫏
騎馬	騎馬 🐎
馬匹	馬匹 🐎
獨角	獨角 🦄
獨角獸	獨角獸 🦄
神獸	神獸 🦄
角獸	角獸 🦄
斑馬	斑馬 🦓
黑白馬	黑白馬 🦓
條紋馬	條紋馬 🦓
草原馬	草原馬 🦓
鹿	鹿 🦌
小鹿	小鹿 🦌
野鹿	野鹿 🦌
野牛	野牛 🦬
大牛	大牛 🦬 🐂
美洲牛	美洲牛 🦬
牛獸	牛獸 🦬
牛臉	牛臉 🐮
牛頭	牛頭 🐮
臉牛	臉牛 🐮
公牛	公牛 🐂
鬥牛	鬥牛 🐂
水牛	水牛 🐃
大水牛	大水牛 🐃
水獸	水獸 🐃
母牛	母牛 🐄
奶牛	奶牛 🐄
家牛	家牛 🐄
牛隻	牛隻 🐄
豬	豬 🐷 🐖
豬臉	豬臉 🐷
小豬	小豬 🐷 🐖
臉豬	臉豬 🐷
家豬	家豬 🐖
肥豬	肥豬 🐖
野豬	野豬 🐗
山豬	山豬 🐗
公豬	公豬 🐗
獵豬	獵豬 🐗
豬鼻	豬鼻 🐽
鼻子	鼻子 🐽 👃
鼻	鼻 🐽 👃
豬鼻子	豬鼻子 🐽
公羊	公羊 🐏
羊	羊 🐏 🐑 🐐
山羊	山羊 🐏 🐐
角羊	角羊 🐏
母羊	母羊 🐑
綿羊	綿羊 🐑
小羊	小羊 🐐
羊角	羊角 🐐
駱駝	駱駝 🐪
單峰	單峰 🐪
沙漠獸	沙漠獸 🐪
駝	駝 🐪
雙峰駝	雙峰駝 🐫
雙峰	雙峰 🐫
沙駝	沙駝 🐫
駱	駱 🐫
羊駝	羊駝 🦙
草泥馬	草泥馬 🦙
小羊駝	小羊駝 🦙
駝羊	駝羊 🦙
長頸鹿	長頸鹿 🦒
長頸	長頸 🦒
高鹿	高鹿 🦒
頸鹿	頸鹿 🦒
象	象 🐘
大象	大象 🐘
長鼻	長鼻 🐘
象群	象群 🐘
長毛象	長毛象 🦣
巨象	巨象 🦣
史前象	史前象 🦣
毛象	毛象 🦣
犀牛	犀牛 🦏
大犀	大犀 🦏
角牛	角牛 🦏
獨角牛	獨角牛 🦏
河馬	河馬 🦛
水馬	水馬 🦛
大嘴馬	大嘴馬 🦛
馬獸	馬獸 🦛
鼠	鼠 🐭 🐹 🐿️ 🖱️
鼠臉	鼠臉 🐭
小鼠	小鼠 🐭 🐁
臉鼠	臉鼠 🐭
老鼠	老鼠 🐁
家鼠	家鼠 🐁
大鼠	大鼠 🐀
黑鼠	黑鼠 🐀
鼠類	鼠類 🐀
地鼠	地鼠 🐀
倉鼠	倉鼠 🐹
寵物鼠	寵物鼠 🐹
小倉鼠	小倉鼠 🐹
兔	兔 🐰 🐇
兔臉	兔臉 🐰
小兔	小兔 🐰 🐇
臉兔	臉兔 🐰
家兔	家兔 🐇
跳兔	跳兔 🐇
花栗鼠	花栗鼠 🐿️
松鼠	松鼠 🐿️
小松	小松 🐿️
河狸	河狸 🦫
建築狸	建築狸 🦫
水狸	水狸 🦫
齧齒	齧齒 🦫
刺蝟	刺蝟 🦔
小刺蝟	小刺蝟 🦔
針鼠	針鼠 🦔
螺毛	螺毛 🦔
蝙蝠	蝙蝠 🦇
夜行蝠	夜行蝠 🦇
飛鼠	飛鼠 🦇
黑翼	黑翼 🦇
大熊	大熊 🐻
森林熊	森林熊 🐻
棕熊	棕熊 🐻
北極熊	北極熊 🐻‍❄️
白熊	白熊 🐻‍❄️
冰熊	冰熊 🐻‍❄️
寒熊	寒熊 🐻‍❄️
無尾熊	無尾熊 🐨
樹袋熊	樹袋熊 🐨
小熊	小熊 🐨
樹熊	樹熊 🐨
熊貓	熊貓 🐼
國寶	國寶 🐼
大熊貓	大熊貓 🐼
黑白熊	黑白熊 🐼
樹懶	樹懶 🦥
懶猴	懶猴 🦥
慢獸	慢獸 🦥
懶熊	懶熊 🦥
水獺	水獺 🦦
海獺	海獺 🦦
小獺	小獺 🦦
獺	獺 🦦
臭鼬	臭鼬 🦨
臭貓	臭貓 🦨
臭獸	臭獸 🦨
黑白鼠	黑白鼠 🦨
袋鼠	袋鼠 🦘
跳跳鼠	跳跳鼠 🦘
澳洲鼠	澳洲鼠 🦘
跳鼠	跳鼠 🦘
獾	獾 🦡
小獾	小獾 🦡
挖洞獸	挖洞獸 🦡
地獸	地獸 🦡
爪印	爪印 🐾
足跡	足跡 🐾 👣
動物腳印	動物腳印 🐾
腳印	腳印 🐾 👣
足印	足印 🐾
噴水鯨	噴水鯨 🐳
鯨	鯨 🐳 🐋
噴鯨	噴鯨 🐳
海鯨	海鯨 🐳 🐋
噴水	噴水 🐳
大鯨	大鯨 🐋
鯨魚	鯨魚 🐋
海豚	海豚 🐬
豚	豚 🐬 🐡
小豚	小豚 🐬
水豚	水豚 🐬
跳豚	跳豚 🐬
海豹	海豹 🦭
水豹	水豹 🦭
小豹	小豹 🦭
小魚	小魚 🐟
魚兒	魚兒 🐟
水魚	水魚 🐟
熱帶魚	熱帶魚 🐠
彩魚	彩魚 🐠
熱魚	熱魚 🐠
花魚	花魚 🐠
河豚	河豚 🐡
鼓魚	鼓魚 🐡
膨魚	膨魚 🐡
鯊魚	鯊魚 🦈
鯊	鯊 🦈
海鯊	海鯊 🦈
大鯊	大鯊 🦈
章魚	章魚 🐙
章	章 🐙
水章	水章 🐙
觸手	觸手 🐙
貝殼	貝殼 🐚
貝	貝 🐚
海貝	海貝 🐚
螺殼	螺殼 🐚
珊瑚	珊瑚 🪸
珊	珊 🪸
海珊	海珊 🪸
珊礁	珊礁 🪸
水母	水母 🪼
母	母 🪼
海母	海母 🪼
傘形母	傘形母 🪼
螃蟹	螃蟹 🦀
蟹	蟹 🦀
海蟹	海蟹 🦀
螯蟹	螯蟹 🦀
龍蝦	龍蝦 🦞
蝦	蝦 🦞 🦐 🍤
大蝦	大蝦 🦞 🍤
海蝦	海蝦 🦞
龍	龍 🦞 🐲 🐉
小蝦	小蝦 🦐
水蝦	水蝦 🦐
蝦仁	蝦仁 🦐
魷魚	魷魚 🦑
魷	魷 🦑
墨魚	墨魚 🦑
魷魷	魷魷 🦑
牡蠣	牡蠣 🦪
蠣	蠣 🦪
蠣肉	蠣肉 🦪
海蠣	海蠣 🦪
鱷魚	鱷魚 🐊
鱷	鱷 🐊
大鱷	大鱷 🐊
水鱷	水鱷 🐊
龜	龜 🐢
海龜	海龜 🐢
陸龜	陸龜 🐢
烏龜	烏龜 🐢
蜥蜴	蜥蜴 🦎
小蜥	小蜥 🦎
陸蜥	陸蜥 🦎
蜥	蜥 🦎
蛇	蛇 🐍
大蛇	大蛇 🐍
陸蛇	陸蛇 🐍
長蛇	長蛇 🐍
龍臉	龍臉 🐲
神龍	神龍 🐲 🐉
臉龍	臉龍 🐲
飛龍	飛龍 🐉
巨龍	巨龍 🐉
長頸龍	長頸龍 🦕
草龍	草龍 🦕
草食龍	草食龍 🦕
頸龍	頸龍 🦕
暴龍	暴龍 🦖
肉食龍	肉食龍 🦖
霸王龍	霸王龍 🦖
恐龍	恐龍 🦖
花束	花束 💐
束	束 💐
群花	群花 💐
櫻花	櫻花 🌸
櫻	櫻 🌸 🍒
春櫻	春櫻 🌸
粉櫻	粉櫻 🌸
白花	白花 💮
白	白 💮
純花	純花 💮
淨花	淨花 💮
蓮花	蓮花 🪷
蓮	蓮 🪷
荷	荷 🪷
蓮蓬	蓮蓬 🪷
花飾	花飾 🏵️
花紋	花紋 🏵️
玫花	玫花 🏵️
圓花	圓花 🏵️
玫瑰	玫瑰 🌹
玫	玫 🌹
花玫	花玫 🌹
紅玫	紅玫 🌹
枯花	枯花 🥀
凋花	凋花 🥀
凋萎	凋萎 🥀
落花	落花 🥀
木槿	木槿 🌺
槿	槿 🌺
紅槿	紅槿 🌺
熱花	熱花 🌺
向日葵	向日葵 🌻
葵	葵 🌻
太陽花	太陽花 🌻
向日	向日 🌻
花朵	花朵 🌼
小花	小花 🌼
花開	花開 🌼
鬱金香	鬱金香 🌷
鬱	鬱 🌷
花鬱	花鬱 🌷
春花	春花 🌷
風信子	風信子 🪻
信子	信子 🪻
芳香花	芳香花 🪻
風花	風花 🪻
幼苗	幼苗 🌱
苗	苗 🌱
新芽	新芽 🌱
發芽	發芽 🌱
盆栽	盆栽 🪴
盆	盆 🪴
植栽	植栽 🪴
室內植物	室內植物 🪴
常青樹	常青樹 🌲
松樹	松樹 🌲
青樹	青樹 🌲
落葉樹	落葉樹 🌳
闊葉樹	闊葉樹 🌳
樹葉	樹葉 🌳
落樹	落樹 🌳
棕櫚樹	棕櫚樹 🌴
椰子樹	椰子樹 🌴
熱帶樹	熱帶樹 🌴
棕櫚	棕櫚 🌴
仙人掌	仙人掌 🌵
多肉	多肉 🌵
刺掌	刺掌 🌵
沙漠植物	沙漠植物 🌵
稻穗	稻穗 🌾
稻	稻 🌾
米	米 🌾 🍚
穀物	穀物 🌾
穗	穗 🌾
草本	草本 🌿
草	草 🌿
香草	香草 🌿
藥草	藥草 🌿
三葉草	三葉草 ☘️
三葉	三葉 ☘️
幸運草	幸運草 ☘️ 🍀
綠葉	綠葉 ☘️ 🍃
四葉草	四葉草 🍀
四葉	四葉 🍀
四片葉	四片葉 🍀
楓葉	楓葉 🍁
楓	楓 🍁
紅葉	紅葉 🍁
楓紅	楓紅 🍁
落葉	落葉 🍂
枯葉	枯葉 🍂
飄葉	飄葉 🍂 🍃
凋葉	凋葉 🍂
微風葉	微風葉 🍃
風吹葉	風吹葉 🍃
空巢	空巢 🪹
巢	巢 🪹 🪺
空鳥巢	空鳥巢 🪹
空巢穴	空巢穴 🪹
巢蛋	巢蛋 🪺
鳥巢	鳥巢 🪺
蛋巢	蛋巢 🪺
蘑菇	蘑菇 🍄 🍄‍🟫
菇	菇 🍄 🍄‍🟫
香菇	香菇 🍄
菇類	菇類 🍄
枯樹	枯樹 🪾
枯木	枯木 🪾
落木	落木 🪾
無葉樹	無葉樹 🪾
阿森松	阿森松 🇦🇨
阿森松島	阿森松島 🇦🇨
安道爾	安道爾 🇦🇩
安道爾國旗	安道爾國旗 🇦🇩
阿聯酋	阿聯酋 🇦🇪
阿拉伯聯合酋長國	阿拉伯聯合酋長國 🇦🇪
阿富汗	阿富汗 🇦🇫
阿富汗國旗	阿富汗國旗 🇦🇫
安巴	安巴 🇦🇬
安提瓜和巴布達	安提瓜和巴布達 🇦🇬
安圭拉	安圭拉 🇦🇮
安圭拉島	安圭拉島 🇦🇮
阿爾巴	阿爾巴 🇦🇱
阿爾巴尼亞	阿爾巴尼亞 🇦🇱
亞美尼亞	亞美尼亞 🇦🇲
亞美尼亞國旗	亞美尼亞國旗 🇦🇲
安哥拉	安哥拉 🇦🇴
安哥拉國旗	安哥拉國旗 🇦🇴
南極	南極 🇦🇶
南極洲	南極洲 🇦🇶
阿根廷	阿根廷 🇦🇷
阿根廷國旗	阿根廷國旗 🇦🇷
美屬薩摩亞	美屬薩摩亞 🇦🇸
薩摩亞	薩摩亞 🇦🇸 🇼🇸
奧地利	奧地利 🇦🇹
奧地利國旗	奧地利國旗 🇦🇹
澳大利亞	澳大利亞 🇦🇺
澳洲	澳洲 🇦🇺 🌏
澳大利亞國旗	澳大利亞國旗 🇦🇺
阿魯巴	阿魯巴 🇦🇼
阿魯巴島	阿魯巴島 🇦🇼
奧蘭	奧蘭 🇦🇽
奧蘭群島	奧蘭群島 🇦🇽
阿塞拜疆	阿塞拜疆 🇦🇿
阿塞拜疆國旗	阿塞拜疆國旗 🇦🇿
波黑	波黑 🇧🇦
波斯尼亞和黑塞哥維那	波斯尼亞和黑塞哥維那 🇧🇦
巴巴多斯	巴巴多斯 🇧🇧
巴巴多斯國旗	巴巴多斯國旗 🇧🇧
孟加拉	孟加拉 🇧🇩
孟加拉國旗	孟加拉國旗 🇧🇩
比利時	比利時 🇧🇪
比利時國旗	比利時國旗 🇧🇪
布基納法索	布基納法索 🇧🇫
布基納法索國旗	布基納法索國旗 🇧🇫
保加利亞	保加利亞 🇧🇬
保加利亞國旗	保加利亞國旗 🇧🇬
巴林	巴林 🇧🇭
巴林國旗	巴林國旗 🇧🇭
布隆迪	布隆迪 🇧🇮
布隆迪國旗	布隆迪國旗 🇧🇮
貝寧	貝寧 🇧🇯
貝寧國旗	貝寧國旗 🇧🇯
聖巴	聖巴 🇧🇱
聖巴泰勒米	聖巴泰勒米 🇧🇱
百慕大	百慕大 🇧🇲
百慕大群島	百慕大群島 🇧🇲
文萊	文萊 🇧🇳
文萊國旗	文萊國旗 🇧🇳
玻利維亞	玻利維亞 🇧🇴
玻利維亞國旗	玻利維亞國旗 🇧🇴
荷屬加勒比	荷屬加勒比 🇧🇶
荷屬加勒比群島	荷屬加勒比群島 🇧🇶
巴西	巴西 🇧🇷
巴西國旗	巴西國旗 🇧🇷
巴哈馬	巴哈馬 🇧🇸
巴哈馬群島	巴哈馬群島 🇧🇸
不丹	不丹 🇧🇹
不丹國旗	不丹國旗 🇧🇹
布韋島	布韋島 🇧🇻
布韋	布韋 🇧🇻
博茨瓦納	博茨瓦納 🇧🇼
博茨瓦納國旗	博茨瓦納國旗 🇧🇼
白俄羅斯	白俄羅斯 🇧🇾
白俄羅斯國旗	白俄羅斯國旗 🇧🇾
伯利茲	伯利茲 🇧🇿
伯利茲國旗	伯利茲國旗 🇧🇿
加拿大	加拿大 🇨🇦
加拿大國旗	加拿大國旗 🇨🇦
科科斯	科科斯 🇨🇨
科科斯群島	科科斯群島 🇨🇨
剛果金	剛果金 🇨🇩
剛果民主共和國	剛果民主共和國 🇨🇩
中非	中非 🇨🇫
中非共和國	中非共和國 🇨🇫
剛果布	剛果布 🇨🇬
剛果共和國	剛果共和國 🇨🇬
瑞士	瑞士 🇨🇭
瑞士國旗	瑞士國旗 🇨🇭
象牙海岸	象牙海岸 🇨🇮
科特迪瓦	科特迪瓦 🇨🇮
庫克群島	庫克群島 🇨🇰
庫克	庫克 🇨🇰
智利	智利 🇨🇱
智利國旗	智利國旗 🇨🇱
喀麥隆	喀麥隆 🇨🇲
喀麥隆國旗	喀麥隆國旗 🇨🇲
中國	中國 🇨🇳
中國國旗	中國國旗 🇨🇳
哥倫比亞	哥倫比亞 🇨🇴
哥倫比亞國旗	哥倫比亞國旗 🇨🇴
克利珀頓	克利珀頓 🇨🇵
克利珀頓島	克利珀頓島 🇨🇵
塞克	塞克 🇨🇶
塞克島	塞克島 🇨🇶
哥斯達黎加	哥斯達黎加 🇨🇷
哥斯達黎加國旗	哥斯達黎加國旗 🇨🇷
古巴	古巴 🇨🇺
古巴國旗	古巴國旗 🇨🇺
佛得角	佛得角 🇨🇻
佛得角群島	佛得角群島 🇨🇻
庫拉索	庫拉索 🇨🇼
庫拉索島	庫拉索島 🇨🇼
聖誕島	聖誕島 🇨🇽
塞浦路斯	塞浦路斯 🇨🇾
塞浦路斯國旗	塞浦路斯國旗 🇨🇾
捷克	捷克 🇨🇿
捷克國旗	捷克國旗 🇨🇿
德國	德國 🇩🇪
德國國旗	德國國旗 🇩🇪
迪戈加西亞	迪戈加西亞 🇩🇬
迪戈加西亞島	迪戈加西亞島 🇩🇬
吉布提	吉布提 🇩🇯
吉布提國旗	吉布提國旗 🇩🇯
丹麥	丹麥 🇩🇰
丹麥國旗	丹麥國旗 🇩🇰
多米尼克	多米尼克 🇩🇲
多米尼克國旗	多米尼克國旗 🇩🇲
多米尼加	多米尼加 🇩🇴
多米尼加共和國	多米尼加共和國 🇩🇴
阿爾及利亞	阿爾及利亞 🇩🇿
阿爾及利亞國旗	阿爾及利亞國旗 🇩🇿
塞烏塔梅利利亞	塞烏塔梅利利亞 🇪🇦
塞烏塔	塞烏塔 🇪🇦
梅利利亞	梅利利亞 🇪🇦
厄瓜多爾	厄瓜多爾 🇪🇨
厄瓜多爾國旗	厄瓜多爾國旗 🇪🇨
愛沙尼亞	愛沙尼亞 🇪🇪
愛沙尼亞國旗	愛沙尼亞國旗 🇪🇪
埃及	埃及 🇪🇬
埃及國旗	埃及國旗 🇪🇬
西撒哈拉	西撒哈拉 🇪🇭
西撒哈拉國旗	西撒哈拉國旗 🇪🇭
厄立特里亞	厄立特里亞 🇪🇷
厄立特里亞國旗	厄立特里亞國旗 🇪🇷
西班牙	西班牙 🇪🇸
西班牙國旗	西班牙國旗 🇪🇸
埃塞俄比亞	埃塞俄比亞 🇪🇹
埃塞俄比亞國旗	埃塞俄比亞國旗 🇪🇹
歐盟	歐盟 🇪🇺
歐洲聯盟	歐洲聯盟 🇪🇺
芬蘭	芬蘭 🇫🇮
芬蘭國旗	芬蘭國旗 🇫🇮
斐濟	斐濟 🇫🇯
斐濟國旗	斐濟國旗 🇫🇯
福克蘭	福克蘭 🇫🇰
福克蘭群島	福克蘭群島 🇫🇰
密克羅尼西亞	密克羅尼西亞 🇫🇲
密克羅尼西亞國旗	密克羅尼西亞國旗 🇫🇲
法羅群島	法羅群島 🇫🇴
法羅	法羅 🇫🇴
法國	法國 🇫🇷
法國國旗	法國國旗 🇫🇷
加蓬	加蓬 🇬🇦
加蓬國旗	加蓬國旗 🇬🇦
英國	英國 🇬🇧
英國國旗	英國國旗 🇬🇧
格林納達	格林納達 🇬🇩
格林納達國旗	格林納達國旗 🇬🇩
喬治亞	喬治亞 🇬🇪
喬治亞國旗	喬治亞國旗 🇬🇪
法屬圭亞那	法屬圭亞那 🇬🇫
圭亞那	圭亞那 🇬🇫 🇬🇾
根西	根西 🇬🇬
根西島	根西島 🇬🇬
加納	加納 🇬🇭
加納國旗	加納國旗 🇬🇭
直布羅陀	直布羅陀 🇬🇮
直布羅陀國旗	直布羅陀國旗 🇬🇮
格陵蘭	格陵蘭 🇬🇱
格陵蘭島	格陵蘭島 🇬🇱
岡比亞	岡比亞 🇬🇲
岡比亞國旗	岡比亞國旗 🇬🇲
幾內亞	幾內亞 🇬🇳
幾內亞國旗	幾內亞國旗 🇬🇳
瓜德羅普	瓜德羅普 🇬🇵
瓜德羅普島	瓜德羅普島 🇬🇵
赤道幾內亞	赤道幾內亞 🇬🇶
赤道幾內亞國旗	赤道幾內亞國旗 🇬🇶
希臘	希臘 🇬🇷
希臘國旗	希臘國旗 🇬🇷
南喬治亞南三明治	南喬治亞南三明治 🇬🇸
南喬治亞	南喬治亞 🇬🇸
南三明治	南三明治 🇬🇸
危地馬拉	危地馬拉 🇬🇹
危地馬拉國旗	危地馬拉國旗 🇬🇹
關島	關島 🇬🇺
關島國旗	關島國旗 🇬🇺
幾內亞比紹	幾內亞比紹 🇬🇼
幾內亞比紹國旗	幾內亞比紹國旗 🇬🇼
圭亞那國旗	圭亞那國旗 🇬🇾
香港	香港 🇭🇰
香港特別行政區	香港特別行政區 🇭🇰
赫德麥克唐納	赫德麥克唐納 🇭🇲
赫德島	赫德島 🇭🇲
麥克唐納島	麥克唐納島 🇭🇲
洪都拉斯	洪都拉斯 🇭🇳
洪都拉斯國旗	洪都拉斯國旗 🇭🇳
克羅地亞	克羅地亞 🇭🇷
克羅地亞國旗	克羅地亞國旗 🇭🇷
海地	海地 🇭🇹
海地國旗	海地國旗 🇭🇹
匈牙利	匈牙利 🇭🇺
匈牙利國旗	匈牙利國旗 🇭🇺
加那利群島	加那利群島 🇮🇨
加那利	加那利 🇮🇨
印尼	印尼 🇮🇩
印度尼西亞	印度尼西亞 🇮🇩
愛爾蘭	愛爾蘭 🇮🇪
愛爾蘭國旗	愛爾蘭國旗 🇮🇪
以色列	以色列 🇮🇱
以色列國旗	以色列國旗 🇮🇱
曼島	曼島 🇮🇲
曼島國旗	曼島國旗 🇮🇲
印度	印度 🇮🇳
印度國旗	印度國旗 🇮🇳
英屬印度洋	英屬印度洋 🇮🇴
英屬印度洋領地	英屬印度洋領地 🇮🇴
伊拉克	伊拉克 🇮🇶
伊拉克國旗	伊拉克國旗 🇮🇶
伊朗	伊朗 🇮🇷
伊朗國旗	伊朗國旗 🇮🇷
冰島	冰島 🇮🇸
冰島國旗	冰島國旗 🇮🇸
意大利	意大利 🇮🇹
意大利國旗	意大利國旗 🇮🇹
澤西	澤西 🇯🇪
澤西島	澤西島 🇯🇪
牙買加	牙買加 🇯🇲
牙買加國旗	牙買加國旗 🇯🇲
約旦	約旦 🇯🇴
約旦國旗	約旦國旗 🇯🇴
日本	日本 🇯🇵 🗾
日本國旗	日本國旗 🇯🇵
肯尼亞	肯尼亞 🇰🇪
肯尼亞國旗	肯尼亞國旗 🇰🇪
吉爾吉斯斯坦	吉爾吉斯斯坦 🇰🇬
吉爾吉斯斯坦國旗	吉爾吉斯斯坦國旗 🇰🇬
柬埔寨	柬埔寨 🇰🇭
柬埔寨國旗	柬埔寨國旗 🇰🇭
基里巴斯	基里巴斯 🇰🇮
基里巴斯國旗	基里巴斯國旗 🇰🇮
科摩羅	科摩羅 🇰🇲
科摩羅國旗	科摩羅國旗 🇰🇲
聖基茨尼維斯	聖基茨尼維斯 🇰🇳
聖基茨和尼維斯	聖基茨和尼維斯 🇰🇳
朝鮮	朝鮮 🇰🇵
朝鮮國旗	朝鮮國旗 🇰🇵
韓國	韓國 🇰🇷
韓國國旗	韓國國旗 🇰🇷
科威特	科威特 🇰🇼
科威特國旗	科威特國旗 🇰🇼
開曼群島	開曼群島 🇰🇾
開曼	開曼 🇰🇾
哈薩克斯坦	哈薩克斯坦 🇰🇿
哈薩克斯坦國旗	哈薩克斯坦國旗 🇰🇿
老撾	老撾 🇱🇦
老撾國旗	老撾國旗 🇱🇦
黎巴嫩	黎巴嫩 🇱🇧
黎巴嫩國旗	黎巴嫩國旗 🇱🇧
聖盧西亞	聖盧西亞 🇱🇨
聖盧西亞國旗	聖盧西亞國旗 🇱🇨
列支敦士登	列支敦士登 🇱🇮
列支敦士登國旗	列支敦士登國旗 🇱🇮
斯里蘭卡	斯里蘭卡 🇱🇰
斯里蘭卡國旗	斯里蘭卡國旗 🇱🇰
利比里亞	利比里亞 🇱🇷
利比里亞國旗	利比里亞國旗 🇱🇷
萊索托	萊索托 🇱🇸
萊索托國旗	萊索托國旗 🇱🇸
立陶宛	立陶宛 🇱🇹
立陶宛國旗	立陶宛國旗 🇱🇹
盧森堡	盧森堡 🇱🇺
盧森堡國旗	盧森堡國旗 🇱🇺
拉脫維亞	拉脫維亞 🇱🇻
拉脫維亞國旗	拉脫維亞國旗 🇱🇻
利比亞	利比亞 🇱🇾
利比亞國旗	利比亞國旗 🇱🇾
摩洛哥	摩洛哥 🇲🇦
摩洛哥國旗	摩洛哥國旗 🇲🇦
摩納哥	摩納哥 🇲🇨
摩納哥國旗	摩納哥國旗 🇲🇨
摩爾多瓦	摩爾多瓦 🇲🇩
摩爾多瓦國旗	摩爾多瓦國旗 🇲🇩
黑山	黑山 🇲🇪
黑山國旗	黑山國旗 🇲🇪
聖馬丁	聖馬丁 🇲🇫 🇸🇽
聖馬丁國旗	聖馬丁國旗 🇲🇫 🇸🇽
馬達加斯加	馬達加斯加 🇲🇬
馬達加斯加國旗	馬達加斯加國旗 🇲🇬
馬紹爾群島	馬紹爾群島 🇲🇭
馬紹爾	馬紹爾 🇲🇭
北馬其頓	北馬其頓 🇲🇰
北馬其頓國旗	北馬其頓國旗 🇲🇰
馬里	馬里 🇲🇱
馬里國旗	馬里國旗 🇲🇱
緬甸	緬甸 🇲🇲
緬甸國旗	緬甸國旗 🇲🇲
蒙古	蒙古 🇲🇳
蒙古國旗	蒙古國旗 🇲🇳
澳門	澳門 🇲🇴
澳門特別行政區	澳門特別行政區 🇲🇴
北馬里亞納群島	北馬里亞納群島 🇲🇵
北馬里亞納	北馬里亞納 🇲🇵
馬提尼克	馬提尼克 🇲🇶
馬提尼克島	馬提尼克島 🇲🇶
毛里塔尼亞	毛里塔尼亞 🇲🇷
毛里塔尼亞國旗	毛里塔尼亞國旗 🇲🇷
蒙特塞拉特	蒙特塞拉特 🇲🇸
蒙特塞拉特島	蒙特塞拉特島 🇲🇸
馬耳他	馬耳他 🇲🇹
馬耳他國旗	馬耳他國旗 🇲🇹
毛里求斯	毛里求斯 🇲🇺
毛里求斯國旗	毛里求斯國旗 🇲🇺
馬爾代夫	馬爾代夫 🇲🇻
馬爾代夫國旗	馬爾代夫國旗 🇲🇻
馬拉維	馬拉維 🇲🇼
馬拉維國旗	馬拉維國旗 🇲🇼
墨西哥	墨西哥 🇲🇽
墨西哥國旗	墨西哥國旗 🇲🇽
馬來西亞	馬來西亞 🇲🇾
馬來西亞國旗	馬來西亞國旗 🇲🇾
莫桑比克	莫桑比克 🇲🇿
莫桑比克國旗	莫桑比克國旗 🇲🇿
納米比亞	納米比亞 🇳🇦
納米比亞國旗	納米比亞國旗 🇳🇦
新喀里多尼亞	新喀里多尼亞 🇳🇨
新喀里多尼亞群島	新喀里多尼亞群島 🇳🇨
尼日爾	尼日爾 🇳🇪
尼日爾國旗	尼日爾國旗 🇳🇪
諾福克島	諾福克島 🇳🇫
諾福克	諾福克 🇳🇫
尼日利亞	尼日利亞 🇳🇬
尼日利亞國旗	尼日利亞國旗 🇳🇬
尼加拉瓜	尼加拉瓜 🇳🇮
尼加拉瓜國旗	尼加拉瓜國旗 🇳🇮
荷蘭	荷蘭 🇳🇱
荷蘭國旗	荷蘭國旗 🇳🇱
挪威	挪威 🇳🇴
挪威國旗	挪威國旗 🇳🇴
尼泊爾	尼泊爾 🇳🇵
尼泊爾國旗	尼泊爾國旗 🇳🇵
瑙魯	瑙魯 🇳🇷
瑙魯國旗	瑙魯國旗 🇳🇷
紐埃	紐埃 🇳🇺
紐埃國旗	紐埃國旗 🇳🇺
新西蘭	新西蘭 🇳🇿
新西蘭國旗	新西蘭國旗 🇳🇿
阿曼	阿曼 🇴🇲
阿曼國旗	阿曼國旗 🇴🇲
巴拿馬	巴拿馬 🇵🇦
巴拿馬國旗	巴拿馬國旗 🇵🇦
秘魯	秘魯 🇵🇪
秘魯國旗	秘魯國旗 🇵🇪
法屬波利尼西亞	法屬波利尼西亞 🇵🇫
波利尼西亞	波利尼西亞 🇵🇫
巴布亞新幾內亞	巴布亞新幾內亞 🇵🇬
新幾內亞	新幾內亞 🇵🇬
菲律賓	菲律賓 🇵🇭
菲律賓國旗	菲律賓國旗 🇵🇭
巴基斯坦	巴基斯坦 🇵🇰
巴基斯坦國旗	巴基斯坦國旗 🇵🇰
波蘭	波蘭 🇵🇱
波蘭國旗	波蘭國旗 🇵🇱
聖皮埃爾密克隆	聖皮埃爾密克隆 🇵🇲
聖皮埃爾	聖皮埃爾 🇵🇲
密克隆	密克隆 🇵🇲
皮特凱恩群島	皮特凱恩群島 🇵🇳
皮特凱恩	皮特凱恩 🇵🇳
波多黎各	波多黎各 🇵🇷
波多黎各國旗	波多黎各國旗 🇵🇷
巴勒斯坦	巴勒斯坦 🇵🇸
巴勒斯坦國旗	巴勒斯坦國旗 🇵🇸
葡萄牙	葡萄牙 🇵🇹
葡萄牙國旗	葡萄牙國旗 🇵🇹
帕勞	帕勞 🇵🇼
帕勞國旗	帕勞國旗 🇵🇼
巴拉圭	巴拉圭 🇵🇾
巴拉圭國旗	巴拉圭國旗 🇵🇾
卡塔爾	卡塔爾 🇶🇦
卡塔爾國旗	卡塔爾國旗 🇶🇦
留尼汪	留尼汪 🇷🇪
留尼汪島	留尼汪島 🇷🇪
羅馬尼亞	羅馬尼亞 🇷🇴
羅馬尼亞國旗	羅馬尼亞國旗 🇷🇴
塞爾維亞	塞爾維亞 🇷🇸
塞爾維亞國旗	塞爾維亞國旗 🇷🇸
俄羅斯	俄羅斯 🇷🇺
俄羅斯國旗	俄羅斯國旗 🇷🇺
盧旺達	盧旺達 🇷🇼
盧旺達國旗	盧旺達國旗 🇷🇼
沙特	沙特 🇸🇦
沙特阿拉伯	沙特阿拉伯 🇸🇦
所羅門群島	所羅門群島 🇸🇧
所羅門	所羅門 🇸🇧
塞舌爾	塞舌爾 🇸🇨
塞舌爾群島	塞舌爾群島 🇸🇨
蘇丹	蘇丹 🇸🇩 👳
蘇丹國旗	蘇丹國旗 🇸🇩
瑞典	瑞典 🇸🇪
瑞典國旗	瑞典國旗 🇸🇪
新加坡	新加坡 🇸🇬
新加坡國旗	新加坡國旗 🇸🇬
聖赫勒拿	聖赫勒拿 🇸🇭
聖赫勒拿島	聖赫勒拿島 🇸🇭
斯洛文尼亞	斯洛文尼亞 🇸🇮
斯洛文尼亞國旗	斯洛文尼亞國旗 🇸🇮
斯瓦爾巴揚馬延	斯瓦爾巴揚馬延 🇸🇯
斯瓦爾巴	斯瓦爾巴 🇸🇯
揚馬延	揚馬延 🇸🇯
斯洛伐克	斯洛伐克 🇸🇰
斯洛伐克國旗	斯洛伐克國旗 🇸🇰
塞拉利昂	塞拉利昂 🇸🇱
塞拉利昂國旗	塞拉利昂國旗 🇸🇱
聖馬力諾	聖馬力諾 🇸🇲
聖馬力諾國旗	聖馬力諾國旗 🇸🇲
塞內加爾	塞內加爾 🇸🇳
塞內加爾國旗	塞內加爾國旗 🇸🇳
索馬里	索馬里 🇸🇴
索馬里國旗	索馬里國旗 🇸🇴
蘇里南	蘇里南 🇸🇷
蘇里南國旗	蘇里南國旗 🇸🇷
南蘇丹	南蘇丹 🇸🇸
南蘇丹國旗	南蘇丹國旗 🇸🇸
聖多美普林西比	聖多美普林西比 🇸🇹
聖多美	聖多美 🇸🇹
普林西比	普林西比 🇸🇹
薩爾瓦多	薩爾瓦多 🇸🇻
薩爾瓦多國旗	薩爾瓦多國旗 🇸🇻
敘利亞	敘利亞 🇸🇾
敘利亞國旗	敘利亞國旗 🇸🇾
斯威士蘭	斯威士蘭 🇸🇿
斯威士蘭國旗	斯威士蘭國旗 🇸🇿
特里斯坦達庫尼亞	特里斯坦達庫尼亞 🇹🇦
特里斯坦	特里斯坦 🇹🇦
達庫尼亞	達庫尼亞 🇹🇦
特克斯凱科斯群島	特克斯凱科斯群島 🇹🇨
特克斯	特克斯 🇹🇨
凱科斯	凱科斯 🇹🇨
乍得	乍得 🇹🇩
乍得國旗	乍得國旗 🇹🇩
法屬南部領地	法屬南部領地 🇹🇫
南部領地	南部領地 🇹🇫
多哥	多哥 🇹🇬
多哥國旗	多哥國旗 🇹🇬
泰國	泰國 🇹🇭
泰國國旗	泰國國旗 🇹🇭
塔吉克斯坦	塔吉克斯坦 🇹🇯
塔吉克斯坦國旗	塔吉克斯坦國旗 🇹🇯
托克勞	托克勞 🇹🇰
托克勞群島	托克勞群島 🇹🇰
東帝汶	東帝汶 🇹🇱
東帝汶國旗	東帝汶國旗 🇹🇱
土庫曼斯坦	土庫曼斯坦 🇹🇲
土庫曼斯坦國旗	土庫曼斯坦國旗 🇹🇲
突尼斯	突尼斯 🇹🇳
突尼斯國旗	突尼斯國旗 🇹🇳
湯加	湯加 🇹🇴
湯加國旗	湯加國旗 🇹🇴
土耳其	土耳其 🇹🇷
土耳其國旗	土耳其國旗 🇹🇷
特立尼達多巴哥	特立尼達多巴哥 🇹🇹
特立尼達	特立尼達 🇹🇹
多巴哥	多巴哥 🇹🇹
圖瓦盧	圖瓦盧 🇹🇻
圖瓦盧國旗	圖瓦盧國旗 🇹🇻
台灣	台灣 🇹🇼
台灣國旗	台灣國旗 🇹🇼
坦桑尼亞	坦桑尼亞 🇹🇿
坦桑尼亞國旗	坦桑尼亞國旗 🇹🇿
烏克蘭	烏克蘭 🇺🇦
烏克蘭國旗	烏克蘭國旗 🇺🇦
烏干達	烏干達 🇺🇬
烏干達國旗	烏干達國旗 🇺🇬
美國邊遠島嶼	美國邊遠島嶼 🇺🇲
邊遠島嶼	邊遠島嶼 🇺🇲
聯合國	聯合國 🇺🇳
聯合國旗幟	聯合國旗幟 🇺🇳
美國	美國 🇺🇸 🌎
美國國旗	美國國旗 🇺🇸
烏拉圭	烏拉圭 🇺🇾
烏拉圭國旗	烏拉圭國旗 🇺🇾
烏茲別克斯坦	烏茲別克斯坦 🇺🇿
烏茲別克斯坦國旗	烏茲別克斯坦國旗 🇺🇿
梵蒂岡	梵蒂岡 🇻🇦
梵蒂岡國旗	梵蒂岡國旗 🇻🇦
聖文森特格林納丁斯	聖文森特格林納丁斯 🇻🇨
聖文森特	聖文森特 🇻🇨
格林納丁斯	格林納丁斯 🇻🇨
委內瑞拉	委內瑞拉 🇻🇪
委內瑞拉國旗	委內瑞拉國旗 🇻🇪
英屬維爾京群島	英屬維爾京群島 🇻🇬
維爾京群島	維爾京群島 🇻🇬 🇻🇮
美屬維爾京群島	美屬維爾京群島 🇻🇮
越南	越南 🇻🇳
越南國旗	越南國旗 🇻🇳
瓦努阿圖	瓦努阿圖 🇻🇺
瓦努阿圖國旗	瓦努阿圖國旗 🇻🇺
瓦利斯富圖納	瓦利斯富圖納 🇼🇫
瓦利斯	瓦利斯 🇼🇫
富圖納	富圖納 🇼🇫
薩摩亞國旗	薩摩亞國旗 🇼🇸
科索沃	科索沃 🇽🇰
科索沃國旗	科索沃國旗 🇽🇰
也門	也門 🇾🇪
也門國旗	也門國旗 🇾🇪
馬約特	馬約特 🇾🇹
馬約特島	馬約特島 🇾🇹
南非	南非 🇿🇦
南非國旗	南非國旗 🇿🇦
贊比亞	贊比亞 🇿🇲
贊比亞國旗	贊比亞國旗 🇿🇲
津巴布韋	津巴布韋 🇿🇼
津巴布韋國旗	津巴布韋國旗 🇿🇼
格旗	格旗 🏁
賽旗	賽旗 🏁
終點旗	終點旗 🏁
三角旗	三角旗 🚩
紅旗	紅旗 🚩
小旗	小旗 🚩
交叉旗	交叉旗 🎌
日本旗	日本旗 🎌
交叉標誌	交叉標誌 🎌
黑旗	黑旗 🏴 🏴‍☠️
暗旗	暗旗 🏴
黑色旗	黑色旗 🏴
白旗	白旗 🏳️
投降旗	投降旗 🏳️
和平旗	和平旗 🏳️
彩虹旗	彩虹旗 🏳️‍🌈
同志旗	同志旗 🏳️‍🌈
多彩旗	多彩旗 🏳️‍🌈
跨性旗	跨性旗 🏳️‍⚧️
性別旗	性別旗 🏳️‍⚧️
變性旗	變性旗 🏳️‍⚧️
海盜旗	海盜旗 🏴‍☠️
骷髏旗	骷髏旗 🏴‍☠️
英格蘭	英格蘭 🏴󠁧󠁢󠁥󠁮󠁧󠁿
英格蘭國旗	英格蘭國旗 🏴󠁧󠁢󠁥󠁮󠁧󠁿
蘇格蘭	蘇格蘭 🏴󠁧󠁢󠁳󠁣󠁴󠁿
蘇格蘭國旗	蘇格蘭國旗 🏴󠁧󠁢󠁳󠁣󠁴󠁿
威爾士	威爾士 🏴󠁧󠁢󠁷󠁬󠁳󠁿
威爾士國旗	威爾士國旗 🏴󠁧󠁢󠁷󠁬󠁳󠁿
筷子	筷子 🥢
筷	筷 🥢
雙筷	雙筷 🥢
木筷	木筷 🥢
餐盤	餐盤 🍽️ 🥢 🍴 🥄 🔪 🫙 🏺
餐具	餐具 🍽️ 🥢 🍴 🥄 🔪 🫙 🏺
盤	盤 🍽️
刀叉盤	刀叉盤 🍽️
刀叉	刀叉 🍴
餐刀	餐刀 🍴 🥢 🍽️ 🥄 🔪 🫙 🏺
餐叉	餐叉 🍴
叉	叉 🍴 ❌
刀	刀 🍴 🔪
湯匙	湯匙 🥄
匙	匙 🥄
餐匙	餐匙 🥄
小匙	小匙 🥄
菜刀	菜刀 🔪
廚刀	廚刀 🔪
廚具刀	廚具刀 🔪
罐子	罐子 🫙
密封罐	密封罐 🫙
儲物罐	儲物罐 🫙
陶罐	陶罐 🏺
古罐	古罐 🏺
陶	陶 🏺
奶瓶	奶瓶 🍼
嬰兒奶	嬰兒奶 🍼
奶	奶 🍼 🥛 🧈
奶瓶子	奶瓶子 🍼
牛奶	牛奶 🥛
白奶	白奶 🥛
奶杯	奶杯 🥛
熱飲	熱飲 ☕ 🍹
熱茶	熱茶 ☕
咖啡	咖啡 ☕ 🫘
飲熱	飲熱 ☕
茶壺	茶壺 🫖
熱壺	熱壺 🫖
泡茶壺	泡茶壺 🫖
茶杯	茶杯 🍵
熱杯	熱杯 🍵
綠茶	綠茶 🍵
清酒	清酒 🍶
日本酒	日本酒 🍶
酒	酒 🍶 🍾 🍺 🍻 🍷
壺酒	壺酒 🍶
香檳	香檳 🍾
酒瓶	酒瓶 🍾
開瓶	開瓶 🍾
紅酒	紅酒 🍷
酒杯	酒杯 🍷 🍸 🍺 🥂 🥃
葡萄酒	葡萄酒 🍷
酒紅	酒紅 🍷
雞尾酒	雞尾酒 🍸
調酒	調酒 🍸
尾酒	尾酒 🍸
熱帶飲料	熱帶飲料 🍹
果酒	果酒 🍹
熱帶酒	熱帶酒 🍹
啤酒	啤酒 🍺
啤	啤 🍺
啤酒乾杯	啤酒乾杯 🍻
乾杯	乾杯 🍻 🥂
啤杯	啤杯 🍻
酒乾杯	酒乾杯 🍻
碰杯	碰杯 🥂
舉杯	舉杯 🥂
威士忌	威士忌 🥃
烈酒	烈酒 🥃
杯酒	杯酒 🥃
倒飲料	倒飲料 🫗
倒水	倒水 🫗
倒	倒 🫗
倒液	倒液 🫗
吸管杯	吸管杯 🥤
飲料杯	飲料杯 🥤
手搖杯	手搖杯 🥤
吸杯	吸杯 🥤
珍奶	珍奶 🧋
奶茶	奶茶 🧋
珍珠茶	珍珠茶 🧋
珍	珍 🧋
飲料盒	飲料盒 🧃
盒飲	盒飲 🧃
果汁盒	果汁盒 🧃
果盒	果盒 🧃
馬黛茶	馬黛茶 🧉
黛茶	黛茶 🧉
南美茶	南美茶 🧉
黛	黛 🧉
冰塊	冰塊 🧊
冰晶	冰晶 🧊
便當	便當 🍱
飯盒	飯盒 🍱 🥡
日便	日便 🍱
當	當 🍱
米餅	米餅 🍘
米果	米果 🍘
餅	餅 🍘 🥮 🥠 🫓 🍪
仙貝	仙貝 🍘
飯糰	飯糰 🍙
糰	糰 🍙
飯球	飯球 🍙
三角飯	三角飯 🍙
白飯	白飯 🍚 🍛
米飯	米飯 🍚
飯	飯 🍚 🍛
咖哩飯	咖哩飯 🍛
咖哩	咖哩 🍛
湯麵	湯麵 🍜
熱麵	熱麵 🍜
麵	麵 🍜 🍞 🍝 🍲
湯	湯 🍜 🥣 🍲
義大利麵	義大利麵 🍝
義麵	義麵 🍝
長麵	長麵 🍝
義	義 🍝
烤地瓜	烤地瓜 🍠
地瓜	地瓜 🍠
烤薯	烤薯 🍠
薯	薯 🍠 🥔
關東煮	關東煮 🍢
關東	關東 🍢
煮物	煮物 🍢
串煮	串煮 🍢
壽司	壽司 🍣
日壽	日壽 🍣
魚飯	魚飯 🍣
壽	壽 🍣
炸蝦	炸蝦 🍤
炸	炸 🍤 💣
魚板	魚板 🍥
魚糕	魚糕 🍥
魚漿	魚漿 🍥
月餅	月餅 🥮
中餅	中餅 🥮
糯米糰	糯米糰 🍡
圓糰	圓糰 🍡
串糰	串糰 🍡
糰子	糰子 🍡
餃子	餃子 🥟
水餃	水餃 🥟
餃	餃 🥟
餛飩	餛飩 🥟
幸運餅乾	幸運餅乾 🥠
甜餅	甜餅 🥠
簽語餅	簽語餅 🥠
外賣盒	外賣盒 🥡
外帶	外帶 🥡
便當盒	便當盒 🥡
葡萄	葡萄 🍇
紫葡萄	紫葡萄 🍇
葡	葡 🍇
果串	果串 🍇
哈密瓜	哈密瓜 🍈
香瓜	香瓜 🍈
瓜	瓜 🍈 🍉 🥒
瓜果	瓜果 🍈
西瓜	西瓜 🍉
甜瓜	甜瓜 🍉
瓜片	瓜片 🍉
橘子	橘子 🍊
柑橘	柑橘 🍊
橘	橘 🍊
果橘	果橘 🍊
檸檬	檸檬 🍋
檬	檬 🍋
黃檬	黃檬 🍋
酸果	酸果 🍋
萊姆	萊姆 🍋‍🟩
青檸檬	青檸檬 🍋‍🟩
檸	檸 🍋‍🟩
青檬	青檬 🍋‍🟩
香蕉	香蕉 🍌
蕉	蕉 🍌
黃蕉	黃蕉 🍌
果蕉	果蕉 🍌
鳳梨	鳳梨 🍍
菠蘿	菠蘿 🍍
果梨	果梨 🍍 🍐
熱帶果	熱帶果 🍍
芒果	芒果 🥭
芒	芒 🥭
熱果	熱果 🥭 🥥
果芒	果芒 🥭
蘋果	蘋果 🍎
紅蘋果	紅蘋果 🍎
蘋	蘋 🍎 🍏
果蘋	果蘋 🍎
青蘋果	青蘋果 🍏
綠蘋果	綠蘋果 🍏
青果	青果 🍏
梨	梨 🍐
水梨	水梨 🍐
白梨	白梨 🍐
桃子	桃子 🍑
水蜜桃	水蜜桃 🍑
果桃	果桃 🍑
櫻桃	櫻桃 🍒
果櫻	果櫻 🍒
雙果	雙果 🍒
草莓	草莓 🍓 🍰
莓	莓 🍓
紅莓	紅莓 🍓
果莓	果莓 🍓 🫐
藍莓	藍莓 🫐
藍果	藍果 🫐
莓果	莓果 🫐
奇異果	奇異果 🥝
奇果	奇果 🥝
綠果	綠果 🥝 🥑
果奇	果奇 🥝
番茄	番茄 🍅
茄	茄 🍅 🍆
紅茄	紅茄 🍅
果茄	果茄 🍅 🍆
綠橄欖	綠橄欖 🫒
果欖	果欖 🫒
油橄欖	油橄欖 🫒
椰子	椰子 🥥
椰	椰 🥥
果椰	果椰 🥥
麵包	麵包 🍞
白麵包	白麵包 🍞
麵片	麵片 🍞
可頌	可頌 🥐
牛角	牛角 🥐
麵角	麵角 🥐
法可	法可 🥐
法棍	法棍 🥖
長棍	長棍 🥖
法麵包	法麵包 🥖
法棍麵	法棍麵 🥖
薄餅	薄餅 🫓
平餅	平餅 🫓
扁餅	扁餅 🫓
椒鹽餅	椒鹽餅 🥨
捲餅	捲餅 🥨 🌯
鹹餅	鹹餅 🥨
繞餅	繞餅 🥨
貝果	貝果 🥯
圓麵包	圓麵包 🥯
貝圈	貝圈 🥯
鬆餅	鬆餅 🥞
鬆	鬆 🥞
圓餅	圓餅 🥞
早餐餅	早餐餅 🥞
格子餅	格子餅 🧇
格餅	格餅 🧇
菱格餅	菱格餅 🧇
起司	起司 🧀 🫕
乳酪	乳酪 🧀
起	起 🧀
起士	起士 🧀
肉骨	肉骨 🍖
骨肉	骨肉 🍖
大骨	大骨 🍖
雞腿	雞腿 🍗
腿	腿 🍗 🦵
肉腿	肉腿 🍗
牛排	牛排 🥩
肉排	肉排 🥩
牛肉	牛肉 🥩
培根	培根 🥓
煎肉	煎肉 🥓
火腿片	火腿片 🥓
漢堡	漢堡 🍔
牛堡	牛堡 🍔
漢	漢 🍔
牛肉堡	牛肉堡 🍔
薯條	薯條 🍟
炸薯	炸薯 🍟
條	條 🍟
炸條	炸條 🍟
披薩	披薩 🍕
比薩	比薩 🍕
義式餅	義式餅 🍕
起司餅	起司餅 🍕
熱狗	熱狗 🌭
香腸包	香腸包 🌭
腸堡	腸堡 🌭
三明治	三明治 🥪
夾心麵包	夾心麵包 🥪
三明	三明 🥪
塔可	塔可 🌮
墨餅	墨餅 🌮
夾餅	夾餅 🌮 🥙
墨塔	墨塔 🌮
墨捲	墨捲 🌯
墨卷	墨卷 🌯
玉米粽	玉米粽 🫔
粽子	粽子 🫔
墨粽	墨粽 🫔
粽	粽 🫔
口袋餅	口袋餅 🥙
餡餅	餡餅 🥙 🥧
中東餅	中東餅 🥙
炸豆丸	炸豆丸 🧆
豆丸	豆丸 🧆
鷹嘴豆	鷹嘴豆 🧆
丸子	丸子 🧆
蛋	蛋 🥚 🎂
白蛋	白蛋 🥚
鷄蛋	鷄蛋 🥚
煎蛋	煎蛋 🍳
炒蛋	炒蛋 🍳
鍋蛋	鍋蛋 🍳
蛋料理	蛋料理 🍳
平底鍋	平底鍋 🥘
鍋菜	鍋菜 🥘
西班牙鍋	西班牙鍋 🥘
火鍋	火鍋 🍲 🫕
燉鍋	燉鍋 🍲
湯鍋	湯鍋 🍲
鍋	鍋 🍲
起司鍋	起司鍋 🫕
起鍋	起鍋 🫕
湯碗	湯碗 🥣
湯匙碗	湯匙碗 🥣
餐碗	餐碗 🥣
沙拉	沙拉 🥗
青菜	青菜 🥗 🥬 🥑 🍆 🥔 🥕 🌽 🌶️ 🫑 🥒 🥦 🧄 🧅 🥜 🫘 🌰 🫚 🫛 🍄‍🟫 🫜
冷菜	冷菜 🥗
生菜盤	生菜盤 🥗
爆米花	爆米花 🍿
玉米花	玉米花 🍿
爆米	爆米 🍿
玉米	玉米 🍿 🌽
奶油	奶油 🧈
牛油	牛油 🧈
黃油	黃油 🧈
鹽	鹽 🧂
白鹽	白鹽 🧂
海鹽	海鹽 🧂
調味	調味 🧂
罐頭	罐頭 🥫
食品罐	食品罐 🥫
食品	食品 🥫
霜淇淋	霜淇淋 🍦
冰淇淋	冰淇淋 🍦 🍨
霜冰	霜冰 🍦
甜冰	甜冰 🍦
刨冰	刨冰 🍧
冰沙	冰沙 🍧
雪花冰	雪花冰 🍧
雪糕	雪糕 🍨
甜甜圈	甜甜圈 🍩
甜圈	甜圈 🍩
圈圈	圈圈 🍩
甜圈餅	甜圈餅 🍩
餅乾	餅乾 🍪 🍘
曲奇	曲奇 🍪
小餅	小餅 🍪
蛋糕	蛋糕 🎂
生日蛋糕	生日蛋糕 🎂
慶生蛋糕	慶生蛋糕 🎂
草莓蛋糕	草莓蛋糕 🍰
小蛋糕	小蛋糕 🍰
蛋糕片	蛋糕片 🍰
杯子蛋糕	杯子蛋糕 🧁
杯蛋糕	杯蛋糕 🧁
杯糕	杯糕 🧁
杯子	杯子 🧁
派	派 🥧
蘋果派	蘋果派 🥧
甜派	甜派 🥧
巧克力	巧克力 🍫
巧克	巧克 🍫
巧棒	巧棒 🍫
巧克棒	巧克棒 🍫
糖果	糖果 🍬 🍦 🍧 🍨 🍩 🍪 🎂 🍰 🧁 🥧 🍫 🍭 🍮 🍯
糖	糖 🍬
糖粒	糖粒 🍬
糖糖	糖糖 🍬
棒棒糖	棒棒糖 🍭
棒糖	棒糖 🍭
糖棒	糖棒 🍭
甜棒	甜棒 🍭
布丁	布丁 🍮
蛋奶凍	蛋奶凍 🍮
奶酪	奶酪 🍮
甜品	甜品 🍮 🍦 🍧 🍨 🍩 🍪 🎂 🍰 🧁 🥧 🍫 🍬 🍭 🍯
蜂蜜	蜂蜜 🍯
蜜	蜜 🍯
甜蜜	甜蜜 🍯
蜜罐	蜜罐 🍯
酪梨	酪梨 🥑
酪	酪 🥑
果酪	果酪 🥑
茄子	茄子 🍆
紫茄	紫茄 🍆
馬鈴薯	馬鈴薯 🥔
土豆	土豆 🥔
薯塊	薯塊 🥔
胡蘿蔔	胡蘿蔔 🥕
紅蘿蔔	紅蘿蔔 🥕
蘿蔔	蘿蔔 🥕
胡蘿	胡蘿 🥕
玉	玉 🌽
粟米	粟米 🌽
玉穗	玉穗 🌽
辣椒	辣椒 🌶️
辣	辣 🌶️
紅椒	紅椒 🌶️ 🫑
甜椒	甜椒 🫑
青椒	青椒 🫑
椒	椒 🫑
小黃瓜	小黃瓜 🥒
黃瓜	黃瓜 🥒
青瓜	青瓜 🥒
葉菜	葉菜 🥬
綠菜	綠菜 🥬 🥦
葉	葉 🥬
花椰菜	花椰菜 🥦
綠花椰	綠花椰 🥦
花椰	花椰 🥦
大蒜	大蒜 🧄
蒜	蒜 🧄
蒜頭	蒜頭 🧄
白蒜	白蒜 🧄
洋蔥	洋蔥 🧅
蔥	蔥 🧅
紅蔥	紅蔥 🧅
白蔥	白蔥 🧅
花生	花生 🥜
生果	生果 🥜
豆	豆 🥜 🫘
果	果 🥜
豆子	豆子 🫘
紅豆	紅豆 🫘
綠豆	綠豆 🫘
栗子	栗子 🌰
栗	栗 🌰
棕栗	棕栗 🌰
糖炒栗	糖炒栗 🌰
薑	薑 🫚
生薑	生薑 🫚
老薑	老薑 🫚
黃薑	黃薑 🫚
豌豆	豌豆 🫛
豌	豌 🫛
青豆	青豆 🫛
豆莢	豆莢 🫛
棕菇	棕菇 🍄‍🟫
茸	茸 🍄‍🟫
根菜	根菜 🫜
根	根 🫜
根類	根類 🫜
根蔬	根蔬 🫜
裝飾本	裝飾本 📔
筆記本	筆記本 📔 📓 💻 🗒️
書本	書本 📔 📖 📚
閉書	閉書 📕
紅書	紅書 📕
書	書 📕 📗 📘 📙 📚
打開書	打開書 📖
開書	開書 📖
閱讀書	閱讀書 📖
綠書	綠書 📗
綠本	綠本 📗
藍書	藍書 📘
藍本	藍本 📘
橙書	橙書 📙
橘本	橘本 📙
書籍	書籍 📚 📔 📕 📖 📗 📘 📙 📓 📒 📃 📜 📄 📰 🗞️ 📑 🔖 🏷️
書堆	書堆 📚
記事本	記事本 📓 🗒️
本子	本子 📓 📝
賬簿	賬簿 📒
帳本	帳本 📒
登記本	登記本 📒
卷頁	卷頁 📃
書頁	書頁 📃 📄
彎頁	彎頁 📃
頁	頁 📃 📄
卷軸	卷軸 📜
書卷	書卷 📜
卷	卷 📜
古卷	古卷 📜
紙頁	紙頁 📄
文件頁	文件頁 📄
報紙	報紙 📰
新聞紙	新聞紙 📰
報	報 📰 🗞️
報刊	報刊 📰
卷報紙	卷報紙 🗞️
報筒	報筒 🗞️
新聞卷	新聞卷 🗞️
書籤	書籤 📑 🔖
籤	籤 📑 🔖
分頁籤	分頁籤 📑
標籤	標籤 📑 🔖 🏷️ 📛
書夾	書夾 🔖
標	標 🏷️
記籤	記籤 🏷️
吊牌	吊牌 🏷️
眼鏡	眼鏡 👓 😎 🤓 🧐
鏡	鏡 👓 🪞
近視鏡	近視鏡 👓
眼鏡框	眼鏡框 👓
墨鏡	墨鏡 🕶️ 😎 🤓 🧐
太陽鏡	太陽鏡 🕶️
黑鏡	黑鏡 🕶️
護目鏡	護目鏡 🥽
防護鏡	防護鏡 🥽
安全鏡	安全鏡 🥽
白袍	白袍 🥼
實驗衣	實驗衣 🥼
醫袍	醫袍 🥼
反光衣	反光衣 🦺
安全衣	安全衣 🦺
背心	背心 🦺
領帶	領帶 👔
正裝帶	正裝帶 👔
領巾	領巾 👔
T恤	T恤 👕
短袖	短袖 👕
圓領衫	圓領衫 👕
牛仔褲	牛仔褲 👖
長褲	長褲 👖
褲	褲 👖 🩲
牛褲	牛褲 👖
圍巾	圍巾 🧣
巾	巾 🧣
頸巾	頸巾 🧣
保暖巾	保暖巾 🧣
手	手 🧤
保暖手套	保暖手套 🧤
防護手套	防護手套 🧤
外套	外套 🧥
大衣	大衣 🧥
外衣	外衣 🧥
保暖衣	保暖衣 🧥
襪子	襪子 🧦
襪	襪 🧦
長襪	長襪 🧦
短襪	短襪 🧦
洋裝	洋裝 👗
裙	裙 👗
長裙	長裙 👗
裙子	裙子 👗
和服	和服 👘
日服	日服 👘
傳統裝	傳統裝 👘
莎麗	莎麗 🥻
印度服	印度服 🥻
飾巾	飾巾 🥻
連身泳衣	連身泳衣 🩱
泳裝	泳裝 🩱
泳衣	泳衣 🩱 👙
三角褲	三角褲 🩲
內褲	內褲 🩲
短褲	短褲 🩳
運動褲	運動褲 🩳
夏褲	夏褲 🩳
比基尼	比基尼 👙
海灘裝	海灘裝 👙
女裝	女裝 👚
女衣	女衣 👚
女上衣	女上衣 👚
摺扇	摺扇 🪭
扇	扇 🪭
手扇	手扇 🪭
涼扇	涼扇 🪭
錢包	錢包 👛 👜
小包	小包 👛 👝
零錢包	零錢包 👛
手提包	手提包 👜 💼
包袋	包袋 👜
包包	包包 👜
手拿包	手拿包 👝
晚宴包	晚宴包 👝
購物袋	購物袋 🛍️
手提袋	手提袋 🛍️
袋	袋 🛍️
背包	背包 🎒
書包	書包 🎒
登山包	登山包 🎒
後背包	後背包 🎒
夾腳拖	夾腳拖 🩴
拖鞋	拖鞋 🩴
沙灘鞋	沙灘鞋 🩴
男鞋	男鞋 👞
正裝鞋	正裝鞋 👞 👠
皮鞋	皮鞋 👞
鞋	鞋 👞
跑鞋	跑鞋 👟
運動鞋	運動鞋 👟
慢跑鞋	慢跑鞋 👟
球鞋	球鞋 👟
登山靴	登山靴 🥾
靴	靴 🥾 👢
防水靴	防水靴 🥾
戶外靴	戶外靴 🥾
平底鞋	平底鞋 🥿
平鞋	平鞋 🥿
舒適鞋	舒適鞋 🥿
高跟鞋	高跟鞋 👠
女鞋	女鞋 👠
涼鞋	涼鞋 👡
女涼鞋	女涼鞋 👡
涼	涼 👡
芭蕾鞋	芭蕾鞋 🩰
舞鞋	舞鞋 🩰
舞蹈鞋	舞蹈鞋 🩰
女靴	女靴 👢
長靴	長靴 👢
冬靴	冬靴 👢
髮梳	髮梳 🪮
梳子	梳子 🪮
頭梳	頭梳 🪮
皇冠	皇冠 👑
王冠	王冠 👑
冠	冠 👑
頭飾	頭飾 👑
女帽	女帽 👒
太陽帽	太陽帽 👒
夏帽	夏帽 👒
帽	帽 👒
禮帽	禮帽 🎩
高帽	高帽 🎩
正帽	正帽 🎩
畢業帽	畢業帽 🎓
學士帽	學士帽 🎓
畢帽	畢帽 🎓
鴨舌帽	鴨舌帽 🧢
棒球帽	棒球帽 🧢
運動帽	運動帽 🧢
軍帽	軍帽 🪖
頭盔	頭盔 🪖
軍盔	軍盔 🪖
救援帽	救援帽 ⛑️
安全帽	安全帽 ⛑️
救盔	救盔 ⛑️
念珠	念珠 📿
佛珠	佛珠 📿
手串	手串 📿
珠串	珠串 📿
口紅	口紅 💄
唇膏	唇膏 💄
彩妝	彩妝 💄
戒指	戒指 💍
婚戒	婚戒 💍
指飾	指飾 💍
寶石	寶石 💎
珠寶	珠寶 💎
裝飾石	裝飾石 💎
鑽	鑽 💎
電池	電池 🔋
能量	能量 🔋
電力	電力 🔋
低電量	低電量 🪫
電量不足	電量不足 🪫
電池耗盡	電池耗盡 🪫
插頭	插頭 🔌
電源	電源 🔌
插座	插座 🔌
電插	電插 🔌
筆電	筆電 💻
移動電腦	移動電腦 💻
電腦	電腦 💻 🔋 🪫 🔌 🖥️ 🖨️ ⌨️ 🖱️ 🖲️ 💽 💾 💿 📀 🧮
台式機	台式機 🖥️
桌電	桌電 🖥️
桌上電腦	桌上電腦 🖥️
螢幕電腦	螢幕電腦 🖥️
印表機	印表機 🖨️
打印機	打印機 🖨️
印機	印機 🖨️
輸出機	輸出機 🖨️
鍵盤	鍵盤 ⌨️ 🎹 #️⃣ *️⃣ 0️⃣ 1️⃣ 2️⃣ 3️⃣ 4️⃣ 5️⃣ 6️⃣ 7️⃣ 8️⃣ 9️⃣ 🔟
鍵	鍵 ⌨️
輸入鍵	輸入鍵 ⌨️
鍵器	鍵器 ⌨️
滑鼠	滑鼠 🖱️
鼠標	鼠標 🖱️
滑標	滑標 🖱️
軌跡球	軌跡球 🖲️
控制球	控制球 🖲️
輸入球	輸入球 🖲️
磁盤	磁盤 💽
磁碟	磁碟 💽
電腦盤	電腦盤 💽
軟盤	軟盤 💾
軟碟	軟碟 💾
軟式盤	軟式盤 💾
光碟	光碟 💿 📀
光盤	光盤 💿
DVD	DVD 📀
影片碟	影片碟 📀
算盤	算盤 🧮
算具	算具 🧮
珠算	珠算 🧮
出入口	出入口 🚪
房門	房門 🚪
電梯	電梯 🛗
升降梯	升降梯 🛗
梯	梯 🛗 🪜
鏡子	鏡子 🪞
反射鏡	反射鏡 🪞
窗戶	窗戶 🪟
窗	窗 🪟
玻璃窗	玻璃窗 🪟
床	床 🛏️
睡床	睡床 🛏️
臥床	臥床 🛏️
沙發	沙發 🛋️
客廳沙發	客廳沙發 🛋️
沙發燈	沙發燈 🛋️
椅子	椅子 🪑
椅	椅 🪑
坐椅	坐椅 🪑
單椅	單椅 🪑
馬桶	馬桶 🚽
廁所	廁所 🚽 🚻 🚾
坐廁	坐廁 🚽
馬桶吸	馬桶吸 🪠
通馬器	通馬器 🪠
吸盤器	吸盤器 🪠
淋浴	淋浴 🚿
蓮蓬頭	蓮蓬頭 🚿
洗澡	洗澡 🚿 🧖 🛀 🛁 🫧
浴缸	浴缸 🛁
泡澡缸	泡澡缸 🛁
洗澡盆	洗澡盆 🛁
捕鼠器	捕鼠器 🪤
陷阱	陷阱 🪤
捕鼠	捕鼠 🪤
剃刀	剃刀 🪒
刮鬍刀	刮鬍刀 🪒
修容刀	修容刀 🪒
潤膚瓶	潤膚瓶 🧴
乳液瓶	乳液瓶 🧴
按壓瓶	按壓瓶 🧴
安全別針	安全別針 🧷
別針	別針 🧷
扣針	扣針 🧷
掃帚	掃帚 🧹
掃把	掃把 🧹
清掃工具	清掃工具 🧹
籃子	籃子 🧺
提籃	提籃 🧺
收納籃	收納籃 🧺
衛生紙	衛生紙 🧻
紙卷	紙卷 🧻
廁紙	廁紙 🧻
水桶	水桶 🪣
桶	桶 🪣
提桶	提桶 🪣
肥皂	肥皂 🧼
皂	皂 🧼
洗手皂	洗手皂 🧼
泡泡	泡泡 🫧
泡	泡 🫧
泡沫	泡沫 🫧
牙刷	牙刷 🪥
刷子	刷子 🪥
清潔刷	清潔刷 🪥
海綿	海綿 🧽
清潔綿	清潔綿 🧽
洗碗綿	洗碗綿 🧽
滅火器	滅火器 🧯
消防器	消防器 🧯
滅火	滅火 🧯
購物車	購物車 🛒
推車	推車 🛒
購物推車	購物推車 🛒
攝影機	攝影機 🎥 📷 📹
錄影機	錄影機 🎥 📹
影機	影機 🎥
攝影	攝影 🎥
膠片	膠片 🎞️
影格	影格 🎞️
膠卷	膠卷 🎞️
膠帶	膠帶 🎞️
放映機	放映機 📽️
投影	投影 📽️
放映	放映 📽️
投影機	投影機 📽️
拍板	拍板 🎬
開拍	開拍 🎬
打板	打板 🎬
錄製板	錄製板 🎬
電視	電視 📺
螢幕	螢幕 📺
視訊顯示器	視訊顯示器 📺
相機	相機 📷 📸
照相機	照相機 📷
相	相 📷
閃光相機	閃光相機 📸
閃燈相機	閃燈相機 📸
閃拍	閃拍 📸
攝像機	攝像機 📹
錄影	錄影 📹
錄影帶	錄影帶 📼
錄帶	錄帶 📼
視訊帶	視訊帶 📼
影帶	影帶 📼
放大鏡	放大鏡 🔍 🔎
左鏡	左鏡 🔍
搜索鏡	搜索鏡 🔍
放大	放大 🔍
右鏡	右鏡 🔎
檢視鏡	檢視鏡 🔎
搜尋	搜尋 🔎 🔍 🕵️
蠟燭	蠟燭 🕯️
燭	燭 🕯️
火燭	火燭 🕯️
燭光	燭光 🕯️
燈泡	燈泡 💡
燈具	燈具 💡
照明燈	照明燈 💡
手電筒	手電筒 🔦
手燈	手燈 🔦
探照燈	探照燈 🔦
照明	照明 🔦 🎥 🎞️ 📽️ 🎬 📺 📷 📸 📹 📼 🔍 🔎 🕯️ 💡 🏮 🪔
紅燈籠	紅燈籠 🏮
中式燈	中式燈 🏮
籠	籠 🏮
印度燈	印度燈 🪔
油燈	油燈 🪔
小燈	小燈 🪔
傳統燈	傳統燈 🪔
鎖定	鎖定 🔒 🔐
鎖	鎖 🔒 🔓 🔏 🔐 🔑 🗝️
上鎖	上鎖 🔒
安全鎖	安全鎖 🔒
解鎖	解鎖 🔓 🗝️
開鎖	開鎖 🔓
解	解 🔓
安全解	安全解 🔓
鎖筆	鎖筆 🔏
保密筆	保密筆 🔏
簽章鎖	簽章鎖 🔏
鎖鑰	鎖鑰 🔐
鑰鎖	鑰鎖 🔐
鑰匙鎖	鑰匙鎖 🔐
鑰匙	鑰匙 🔑 🔒 🔓 🔏 🔐 🗝️
鑰	鑰 🔑
鎖匙	鎖匙 🔑
金鑰	金鑰 🔑
老鑰匙	老鑰匙 🗝️
舊鑰匙	舊鑰匙 🗝️
古鑰	古鑰 🗝️
舊鑰	舊鑰 🗝️
信封	信封 ✉️ 📨
封信	封信 ✉️
郵件封	郵件封 ✉️
電子郵件	電子郵件 📧
網絡信	網絡信 📧
郵件	郵件 📧 ✉️ 📨 📩 📤 📥 📦 📫 📪 📬 📭 📮 🗳️
收信	收信 📨
收件	收件 📨
信封箭頭	信封箭頭 📩
發送信	發送信 📩
傳送信	傳送信 📩
發件箱	發件箱 📤
郵件箱	郵件箱 📤 📬 🗳️
寄信箱	寄信箱 📤
收件箱	收件箱 📥 📪
郵箱	郵箱 📥 📫 📪 📮
信箱	信箱 📥
包裹	包裹 📦
物品包	物品包 📦
閉合郵箱	閉合郵箱 📫 📪
投遞箱	投遞箱 📫
開放郵箱	開放郵箱 📬 📭
開箱	開箱 📬
開信箱	開信箱 📭
郵筒	郵筒 📮
信筒	信筒 📮
投票箱	投票箱 🗳️
票箱	票箱 🗳️
注射器	注射器 💉
打針	打針 💉 🩹
注射	注射 💉
血滴	血滴 🩸
血	血 🩸
血液	血液 🩸
藥丸	藥丸 💊
藥	藥 💊
膠囊	膠囊 💊
吃藥	吃藥 💊 🥼
創可貼	創可貼 🩹
貼布	貼布 🩹
傷口貼	傷口貼 🩹
貼	貼 🩹
拐杖	拐杖 🩼
支撐杖	支撐杖 🩼
助行	助行 🩼
聽診器	聽診器 🩺
聽診	聽診 🩺
聽	聽 🩺
醫聽器	醫聽器 🩺
X光	X光 🩻
透視圖	透視圖 🩻
醫用光	醫用光 🩻
掃描	掃描 🩻
錢袋	錢袋 💰
財袋	財袋 💰
財包	財包 💰
硬幣	硬幣 🪙
錢幣	錢幣 🪙
金幣	金幣 🪙
日元	日元 💴
日幣	日幣 💴
日紙	日紙 💴
美元	美元 💵 💲
美幣	美幣 💵
美鈔	美鈔 💵
歐元	歐元 💶
歐幣	歐幣 💶
歐鈔	歐鈔 💶
英鎊	英鎊 💷
鎊幣	鎊幣 💷
鎊鈔	鎊鈔 💷
飛錢	飛錢 💸
金錢流失	金錢流失 💸
信用卡	信用卡 💳
財卡	財卡 💳
卡	卡 💳
收據	收據 🧾
發票	發票 🧾 📄
財單	財單 🧾
日元增長	日元增長 💹
資產增長	資產增長 💹
樂譜	樂譜 🎼
曲譜	曲譜 🎼
音符	音符 🎼 🎵
樂符	樂符 🎵
曲符	曲符 🎵
音符群	音符群 🎶
樂符群	樂符群 🎶
麥克風	麥克風 🎙️ 🎤
錄音麥	錄音麥 🎙️
克風	克風 🎙️
音量條	音量條 🎚️
調音條	調音條 🎚️
控制鈕	控制鈕 🎛️
調節鈕	調節鈕 🎛️
手麥	手麥 🎤
唱麥	唱麥 🎤
耳機	耳機 🎧
音樂耳機	音樂耳機 🎧
收音機	收音機 📻
廣播機	廣播機 📻
薩克斯	薩克斯 🎷
管樂	管樂 🎷 🎺 🪈
樂管	樂管 🎷
手風琴	手風琴 🪗
鍵盤琴	鍵盤琴 🪗
音樂琴	音樂琴 🪗
吉他	吉他 🎸
弦樂	弦樂 🎸 🎻 🪕 🪉
音樂弦	音樂弦 🎸 🪕 🪉
樂鍵	樂鍵 🎹
音樂鍵	音樂鍵 🎹
小號	小號 🎺
音樂管	音樂管 🎺
小提琴	小提琴 🎻
提琴	提琴 🎻
班卓琴	班卓琴 🪕
鼓	鼓 🥁
打擊	打擊 🥁
音樂鼓	音樂鼓 🥁 🪘
長鼓	長鼓 🪘
打擊樂	打擊樂 🪘
沙鈴	沙鈴 🪇
打擊鈴	打擊鈴 🪇
音樂鈴	音樂鈴 🪇
長笛	長笛 🪈
笛	笛 🪈
豎琴	豎琴 🪉
公文包	公文包 💼
文件包	文件包 💼
文件夾	文件夾 📁 📂
資料夾	資料夾 📁
夾子	夾子 📁 📎 🗜️
開夾	開夾 📂
開資料夾	開資料夾 📂
索引卡	索引卡 🗂️
卡片分頁	卡片分頁 🗂️
索引	索引 🗂️
日曆	日曆 📅 📆 🗓️
月曆	月曆 📅
曆	曆 📅
撕曆	撕曆 📆
撕頁曆	撕頁曆 📆
螺旋本	螺旋本 🗒️
螺旋曆	螺旋曆 🗓️
掛曆	掛曆 🗓️
卡片盒	卡片盒 📇
索引盒	索引盒 📇
資料卡	資料卡 📇
上升圖	上升圖 📈
趨勢圖	趨勢圖 📈
升圖	升圖 📈
下降圖	下降圖 📉
跌圖	跌圖 📉
退圖	退圖 📉
柱狀圖	柱狀圖 📊
條形圖	條形圖 📊
圖表	圖表 📊 📈 📉
記錄板	記錄板 📋
夾板	夾板 📋
板子	板子 📋
大頭針	大頭針 📌
圖釘	圖釘 📌
圓針	圓針 📍
圓頭針	圓頭針 📍
定位針	定位針 📍
回形針	回形針 📎
釘	釘 📎
連夾	連夾 🖇️
雙夾	雙夾 🖇️
鏈夾	鏈夾 🖇️
直尺	直尺 📏
尺子	尺子 📏
測量尺	測量尺 📏
三角尺	三角尺 📐
角尺	角尺 📐
測角尺	測角尺 📐
剪刀	剪刀 ✂️
剪子	剪子 ✂️
裁剪	裁剪 ✂️
文件箱	文件箱 🗃️
索引箱	索引箱 🗃️
檔案盒	檔案盒 🗃️
文件櫃	文件櫃 🗄️
檔案櫃	檔案櫃 🗄️
資料櫃	資料櫃 🗄️
垃圾桶	垃圾桶 🗑️ 🚮
紙屑桶	紙屑桶 🗑️
回收桶	回收桶 🗑️
香煙	香煙 🚬
煙	煙 🚬
口煙	口煙 🚬
棺材	棺材 ⚰️
棺	棺 ⚰️
木棺	木棺 ⚰️
墓碑	墓碑 🪦
墓石	墓石 🪦
墓碑石	墓碑石 🪦
骨灰罈	骨灰罈 ⚱️
骨罈	骨罈 ⚱️
罈	罈 ⚱️
護身符	護身符 🧿
符	符 🧿
咒符	咒符 🧿
哈姆薩	哈姆薩 🪬
薩手	薩手 🪬
幸運符	幸運符 🪬
摩艾	摩艾 🗿
石像	石像 🗿
艾像	艾像 🗿
標語牌	標語牌 🪧
牌子	牌子 🪧
佈告牌	佈告牌 🪧
身份證	身份證 🪪
證件	證件 🪪
身分卡	身分卡 🪪
手機	手機 📱 📳 📴
智慧機	智慧機 📱
智能機	智能機 📱
發送機	發送機 📲
手機箭	手機箭 📲
接收機	接收機 📲
座機	座機 ☎️
電話	電話 ☎️ 🤙 📱 📲 📞 📟 📠
固話	固話 ☎️
話筒	話筒 📞
聽筒	聽筒 📞
接聽器	接聽器 📞
傳呼機	傳呼機 📟
呼機	呼機 📟
呼叫器	呼叫器 📟
傳真機	傳真機 📠
傳真	傳真 📠
電傳	電傳 📠
蒸餾器	蒸餾器 ⚗️
實驗器	實驗器 ⚗️
科學器	科學器 ⚗️
試管	試管 🧪
實驗管	實驗管 🧪
科學管	科學管 🧪
培養皿	培養皿 🧫
實驗皿	實驗皿 🧫
科學皿	科學皿 🧫
DNA	DNA 🧬
科學DNA	科學DNA 🧬
實驗DNA	實驗DNA 🧬
顯微鏡	顯微鏡 🔬
實驗鏡	實驗鏡 🔬 🔭
科學鏡	科學鏡 🔬 🔭
望遠鏡	望遠鏡 🔭
衛星天線	衛星天線 📡
科學天線	科學天線 📡
實驗天線	實驗天線 📡
靜音	靜音 🔇
無聲	無聲 🔇
關音	關音 🔇
小聲	小聲 🔈 🤫
低音	低音 🔈
微音	微音 🔈
中聲	中聲 🔉
中音	中音 🔉
適音	適音 🔉
大聲	大聲 🔊
高音	高音 🔊
響亮	響亮 🔊
喇叭	喇叭 📢
擴音	擴音 📢
音響	音響 📢
擴音器	擴音器 📣
喊話器	喊話器 📣
大聲公	大聲公 📣
號角	號角 📯
喇叭角	喇叭角 📯
音角	音角 📯
鈴鐺	鈴鐺 🔔 🛎️
響鈴	響鈴 🔔
禁鈴	禁鈴 🔕
無聲鈴	無聲鈴 🔕
靜鈴	靜鈴 🔕
錘子	錘子 🔨
錘	錘 🔨
打錘	打錘 🔨
斧頭	斧頭 🪓
斧	斧 🪓
劈斧	劈斧 🪓
鶴嘴鋤	鶴嘴鋤 ⛏️
鋤	鋤 ⛏️
挖鋤	挖鋤 ⛏️
錘鋤	錘鋤 ⚒️
錘與鋤	錘與鋤 ⚒️
工具組	工具組 ⚒️
錘扳	錘扳 🛠️
錘與扳	錘與扳 🛠️
手工具	手工具 🛠️
匕首	匕首 🗡️
短劍	短劍 🗡️
小刀	小刀 🗡️
雙劍	雙劍 ⚔️
劍	劍 ⚔️
戰劍	戰劍 ⚔️
炸彈	炸彈 💣
爆彈	爆彈 💣
回力鏢	回力鏢 🪃
投擲鏢	投擲鏢 🪃
弓箭	弓箭 🏹
弓	弓 🏹
弓弦	弓弦 🏹
盾牌	盾牌 🛡️
盾	盾 🛡️
防具	防具 🛡️
木工鋸	木工鋸 🪚
鋸	鋸 🪚
鋸子	鋸子 🪚
扳手	扳手 🔧
扳	扳 🔧
工具扳	工具扳 🔧
螺絲刀	螺絲刀 🪛
起子	起子 🪛
螺刀	螺刀 🪛
螺栓	螺栓 🔩
螺母	螺母 🔩
螺	螺 🔩
齒輪	齒輪 ⚙️
齒	齒 ⚙️ 🦷
齒件	齒件 ⚙️
夾具	夾具 🗜️
固定夾	固定夾 🗜️
天平	天平 ⚖️
秤	秤 ⚖️
平衡秤	平衡秤 ⚖️
白手杖	白手杖 🦯
手杖	手杖 🦯
導盲杖	導盲杖 🦯
鏈接	鏈接 🔗
鏈	鏈 🔗
鎖鏈	鎖鏈 🔗 ⛓️
斷鏈	斷鏈 ⛓️‍💥
破鏈	破鏈 ⛓️‍💥
裂鏈	裂鏈 ⛓️‍💥
鏈條	鏈條 ⛓️
鐵鏈	鐵鏈 ⛓️
鉤子	鉤子 🪝
掛鉤	掛鉤 🪝
鉤	鉤 🪝
工具箱	工具箱 🧰
箱	箱 🧰
工具包	工具包 🧰
磁鐵	磁鐵 🧲
吸鐵	吸鐵 🧲
磁	磁 🧲
梯子	梯子 🪜
登梯	登梯 🪜
鏟子	鏟子 🪏
鏟	鏟 🪏
鐵鏟	鐵鏟 🪏
鉛筆	鉛筆 ✏️
筆	筆 ✏️
素描筆	素描筆 ✏️
筆尖	筆尖 ✒️
鋼尖	鋼尖 ✒️
黑尖	黑尖 ✒️
鋼筆	鋼筆 🖋️
墨筆	墨筆 🖋️
書寫筆	書寫筆 🖋️ 🖊️
原子筆	原子筆 🖊️
圓珠筆	圓珠筆 🖊️
畫筆	畫筆 🖌️
油筆	油筆 🖌️
毛筆	毛筆 🖌️
蠟筆	蠟筆 🖍️
彩筆	彩筆 🖍️
兒童筆	兒童筆 🖍️
備忘錄	備忘錄 📝
記事	記事 📝
手臂	手臂 💪
肌肉	肌肉 💪
手肌	手肌 💪
機械手	機械手 🦾
手械	手械 🦾
機臂	機臂 🦾
機械腿	機械腿 🦿
腿械	腿械 🦿
機腿	機腿 🦿
大腿	大腿 🦵
小腿	小腿 🦵
腳	腳 🦶
腳掌	腳掌 🦶
耳朵	耳朵 👂
聽器	聽器 👂
耳	耳 👂
助聽耳	助聽耳 🦻
聽力輔助	聽力輔助 🦻
聽障耳	聽障耳 🦻
嗅覺	嗅覺 👃
腦	腦 🧠
腦袋	腦袋 🧠
大腦	大腦 🧠
心臟	心臟 🫀
心器	心器 🫀
肺	肺 🫁
肺部	肺部 🫁
呼吸器	呼吸器 🫁
牙	牙 🦷
牙齒	牙齒 🦷
骨	骨 🦴
骨頭	骨頭 🦴 💀 ☠️
骨骼	骨骼 🦴
眼睛	眼睛 👀 👁️
目	目 👀 👁️
雙眼	雙眼 👀
單眼	單眼 👁️
舌頭	舌頭 👅 😋 😛 😜 🤪 😝 🤑
舌	舌 👅
味覺	味覺 👅
嘴巴	嘴巴 👄
嘴	嘴 👄
口	口 👄
咬唇	咬唇 🫦
唇	唇 🫦
嘴唇	嘴唇 🫦
牽手	牽手 🧑‍🤝‍🧑
朋友	朋友 🧑‍🤝‍🧑 👭 👬 🤝 👫
伴侶	伴侶 🧑‍🤝‍🧑 👫 💕 👭 👬 💏 💑
女女牽手	女女牽手 👭
女伴	女伴 👭
男女牽手	男女牽手 👫
情侶	情侶 👫 💏 💑
男男牽手	男男牽手 👬
男伴	男伴 👬
接吻	接吻 💏
親親	親親 💏
愛心伴	愛心伴 💑
心戀	心戀 💑
讚	讚 👍 💯 🫶
好	好 👍 🙆 🆗
噓	噓 👎
不	不 👎
拳頭	拳頭 ✊
舉拳	舉拳 ✊
握拳	握拳 ✊ 👍 👎 👊 🤛 🤜
揮拳	揮拳 👊
出拳	出拳 👊
正拳	正拳 👊
左拳	左拳 🤛
左揮	左揮 🤛
左手拳	左手拳 🤛
右拳	右拳 🤜
右揮	右揮 🤜
右手拳	右手拳 🤜
揮手	揮手 👋 🙌 💁 🤚 🖐️ ✋ 🖖 🫱 🫲 🫳 🫴 🫷 🫸
打招呼	打招呼 👋
手勢	手勢 👋 👌 🤟 🤘 🤙 🤌 🤏 ✌️ 🤞 🫰 🙍 🙎 🙅 🙆 💁 🙋 🧏 🙇 🤦 🤷
手背	手背 🤚
舉手	舉手 🤚 ✋ 🙌 🙋
背手	背手 🤚
張開手	張開手 🖐️
五指張開	五指張開 🖐️
手掌	手掌 🖐️ ✋
停止	停止 ✋ ⏸️ ⏹️ ⛔ 🛑
瓦肯禮	瓦肯禮 🖖
星際迷	星際迷 🖖
禮手	禮手 🖖
右手	右手 🫱
向右手	向右手 🫱
指右	指右 🫱 👉
左手	左手 🫲
向左手	向左手 🫲
指左	指左 🫲 👈
手心下	手心下 🫳
向下掌	向下掌 🫳
掌下	掌下 🫳
手心上	手心上 🫴
向上掌	向上掌 🫴
掌上	掌上 🫴
左推手	左推手 🫷
推左手	推左手 🫷
掌左	掌左 🫷
右推手	右推手 🫸
推右手	推右手 🫸
掌右	掌右 🫸
OK手	OK手 👌
勝利手	勝利手 👌 ✌️
捏手	捏手 🤌
手指捏	手指捏 🤌
捏	捏 🤌
捏手指	捏手指 🤏
小捏	小捏 🤏
捏住	捏住 🤏
V手	V手 ✌️
勝利	勝利 ✌️
交叉手指	交叉手指 🤞
祈願手	祈願手 🤞
交叉	交叉 🤞
手指交叉	手指交叉 🫰
交叉手	交叉手 🫰
小手勢	小手勢 🫰
愛你手	愛你手 🤟
愛心手	愛心手 🤟 🫶
搖滾手	搖滾手 🤘
搖滾	搖滾 🤘
打電話手	打電話手 🤙
寫字	寫字 ✍️
書寫	書寫 ✍️ ✏️ ✒️ 🖋️ 🖊️ 🖌️ 🖍️ 📝
筆記	筆記 ✍️ ✏️ ✒️ 🖋️ 🖊️ 🖌️ 🖍️ 📝
指甲油	指甲油 💅
美甲	美甲 💅
塗指	塗指 💅
自拍	自拍 🤳
拍照	拍照 🤳 📸
拍自己	拍自己 🤳
向左	向左 👈 ⬅️
左指	左指 👈
向右	向右 👉 ➡️
右指	右指 👉
向上	向上 👆 🆙 ⬆️ 🔼 📈
上指	上指 👆
指上	指上 👆
中指	中指 🖕
粗魯	粗魯 🖕
比中	比中 🖕
向下	向下 👇 ⬇️ 🔽 📉
下指	下指 👇
指下	指下 👇
上一指	上一指 ☝️
舉指	舉指 ☝️
手指上	手指上 ☝️
指你	指你 🫵
你你	你你 🫵
指著	指著 🫵
鼓掌	鼓掌 👏 🙌
掌聲	掌聲 👏
心手	心手 🫶
張手	張手 👐
展開手	展開手 👐
合掌	合掌 🤲
祈禱手	祈禱手 🤲
握手	握手 🤝 🙋
合手	合手 🤝
祈禱	祈禱 🙏 🛐
手合	手合 🙏
按摩	按摩 💆
放鬆	放鬆 💆 😥 😌 🧘 🛀 🛌 😔 😪 🤤 😴 🫩 ☕
按壓	按壓 💆
剪髮	剪髮 💇
理髮	理髮 💇
剪頭髮	剪頭髮 💇
走路	走路 🚶
行走	行走 🚶
行人	行人 🚶
走路右	走路右 🚶‍➡️
走向右	走向右 🚶‍➡️
向右走	向右走 🚶‍➡️
站立	站立 🧍
站著	站著 🧍
停留	停留 🧍
跪下	跪下 🧎
跪姿	跪姿 🧎
跪著	跪著 🧎
跪右	跪右 🧎‍➡️
向右跪	向右跪 🧎‍➡️
跪姿右	跪姿右 🧎‍➡️
行走輔助	行走輔助 🧑‍🦯
盲杖	盲杖 🧑‍🦯
導盲右	導盲右 🧑‍🦯‍➡️
盲杖右	盲杖右 🧑‍🦯‍➡️
向右導盲	向右導盲 🧑‍🦯‍➡️
電動輪椅	電動輪椅 🧑‍🦼 🦼
輪椅人	輪椅人 🧑‍🦼 🧑‍🦽
移動輔助	移動輔助 🧑‍🦼
電椅右	電椅右 🧑‍🦼‍➡️
輪椅右	輪椅右 🧑‍🦼‍➡️ 🧑‍🦽‍➡️
向右輪椅	向右輪椅 🧑‍🦼‍➡️ 🧑‍🦽‍➡️
手動輪椅	手動輪椅 🧑‍🦽 🦽
推輪椅	推輪椅 🧑‍🦽
手椅右	手椅右 🧑‍🦽‍➡️
快跑	快跑 🏃
奔跑	奔跑 🏃
跑右	跑右 🏃‍➡️
向右跑	向右跑 🏃‍➡️
快跑右	快跑右 🏃‍➡️
女舞者	女舞者 💃
跳舞	跳舞 💃 🕺
女跳	女跳 💃
男舞者	男舞者 🕺
男跳	男跳 🕺
飄浮	飄浮 🕴️
正裝	正裝 🕴️
飄人	飄人 🕴️
兔耳	兔耳 👯
雙人跳	雙人跳 👯
女舞伴	女舞伴 👯
蒸氣室	蒸氣室 🧖
桑拿	桑拿 🧖
攀岩	攀岩 🧗
爬牆	爬牆 🧗
攀登	攀登 🧗
小天使	小天使 👼
天使	天使 👼 😇
寶寶天使	寶寶天使 👼
聖誕老公公	聖誕老公公 🎅 🎁
聖誕老人	聖誕老人 🎅
老公公	老公公 🎅
聖誕奶奶	聖誕奶奶 🤶
老奶奶	老奶奶 🤶
聖誕婦人	聖誕婦人 🤶
聖誕人	聖誕人 🧑‍🎄
聖誕中性	聖誕中性 🧑‍🎄
中性老人	中性老人 🧑‍🎄
超級英雄	超級英雄 🦸
英雄	英雄 🦸
超人	超人 🦸
反派	反派 🦹
壞蛋	壞蛋 🦹
超級壞人	超級壞人 🦹
魔法師	魔法師 🧙
巫師	巫師 🧙
法師	法師 🧙
小仙子	小仙子 🧚
精靈	精靈 🧚 🧝
仙女	仙女 🧚
吸血鬼	吸血鬼 🧛
夜行者	夜行者 🧛
血族	血族 🧛
美人魚	美人魚 🧜
人魚	人魚 🧜
海中人	海中人 🧜
耳尖人	耳尖人 🧝
幻想族	幻想族 🧝
精靈神	精靈神 🧞
灯神	灯神 🧞
魔神	魔神 🧞
殭屍	殭屍 🧟
活屍	活屍 🧟
喪屍	喪屍 🧟
巨魔	巨魔 🧌
怪物	怪物 🧌 👹 👾 💩 🤡 👺 👻 👽 🤖
地下怪	地下怪 🧌
皺眉	皺眉 🙍 ☹️
生氣	生氣 🙍 😾 💢 🗯️ 😠 😤 😡 🤬 😈 👿 💀 ☠️
臉部表情	臉部表情 🙍
撅嘴	撅嘴 🙎
噘嘴	噘嘴 🙎
不高興	不高興 🙎
搖頭	搖頭 🙅 🙂‍↔️ 🙂‍↕️
不行	不行 🙅 🙂‍↕️
拒絕	拒絕 🙅
點頭	點頭 🙆
OK手勢	OK手勢 🙆
擺手	擺手 💁
示意	示意 💁
問題	問題 🙋
聾人	聾人 🧏
失聰人	失聰人 🧏
耳聾	耳聾 🧏
鞠躬	鞠躬 🙇
行禮	行禮 🙇
致敬	致敬 🙇 🫡
撞頭	撞頭 🤦
哎呀	哎呀 🤦
無奈	無奈 🤦 🙄 😮‍💨 😅 😑 😓
聳肩	聳肩 🤷
不知道	不知道 🤷
無所謂	無所謂 🤷
打坐	打坐 🧘
冥想	冥想 🧘
坐禪	坐禪 🧘
泡澡	泡澡 🛀
沐浴	沐浴 🛀
睡覺	睡覺 🛌 😴 💤
躺床	躺床 🛌
休息床	休息床 🛌
醫護人員	醫護人員 🧑‍⚕️
健康工作者	健康工作者 🧑‍⚕️
醫生	醫生 🧑‍⚕️
學生	學生 🧑‍🎓
學人	學人 🧑‍🎓
學者	學者 🧑‍🎓
老師	老師 🧑‍🏫
教師	教師 🧑‍🏫
教書	教書 🧑‍🏫
法官	法官 🧑‍⚖️
審判官	審判官 🧑‍⚖️
法律人員	法律人員 🧑‍⚖️
農夫	農夫 🧑‍🌾
農業工作者	農業工作者 🧑‍🌾
田間人	田間人 🧑‍🌾
廚師	廚師 🧑‍🍳
烹飪師	烹飪師 🧑‍🍳
食物製作者	食物製作者 🧑‍🍳
機械工	機械工 🧑‍🔧
工程師	工程師 🧑‍🔧
修車工	修車工 🧑‍🔧
工廠工人	工廠工人 🧑‍🏭
製造工	製造工 🧑‍🏭
產業工作者	產業工作者 🧑‍🏭
辦公室人員	辦公室人員 🧑‍💼
辦公工作者	辦公工作者 🧑‍💼
上班族	上班族 🧑‍💼
科學家	科學家 🧑‍🔬
研究者	研究者 🧑‍🔬
實驗人員	實驗人員 🧑‍🔬
科技人員	科技人員 🧑‍💻
IT人員	IT人員 🧑‍💻
技術員	技術員 🧑‍💻
歌手	歌手 🧑‍🎤
演唱者	演唱者 🧑‍🎤
音樂人	音樂人 🧑‍🎤
藝術家	藝術家 🧑‍🎨
創作者	創作者 🧑‍🎨
畫家	畫家 🧑‍🎨
飛行員	飛行員 🧑‍✈️
駕駛員	駕駛員 🧑‍✈️
空中領航	空中領航 🧑‍✈️
太空人	太空人 🧑‍🚀
宇航員	宇航員 🧑‍🚀
太空探險家	太空探險家 🧑‍🚀
消防員	消防員 🧑‍🚒
救火員	救火員 🧑‍🚒
火警	火警 🧑‍🚒
警察	警察 👮
警員	警員 👮
執法人員	執法人員 👮
偵探	偵探 🕵️
私家偵探	私家偵探 🕵️
探員	探員 🕵️
守衛	守衛 💂
護衛	護衛 💂
保安	保安 💂
忍者	忍者 🥷
隱身者	隱身者 🥷
武士	武士 🥷
建築工人	建築工人 👷
工程工人	工程工人 👷
鋼筋工	鋼筋工 👷
王冠人	王冠人 🫅
皇帝	皇帝 🫅
國王	國王 🫅
王子	王子 🤴
皇子	皇子 🤴
貴族	貴族 🤴 👸 🧐
公主	公主 👸
皇女	皇女 👸
圍頭巾人	圍頭巾人 👳
長巾	長巾 👳
戴小帽人	戴小帽人 👲
傳統帽子	傳統帽子 👲
頭巾女士	頭巾女士 🧕
穿頭巾的女人	穿頭巾的女人 🧕
穿燕尾服人	穿燕尾服人 🤵
正裝人	正裝人 🤵
戴面紗人	戴面紗人 👰
新娘	新娘 👰
懷孕女性	懷孕女性 🤰
孕婦	孕婦 🤰
孕媽	孕媽 🤰
懷孕男性	懷孕男性 🫃
孕男	孕男 🫃
孕人	孕人 🫄
孕者	孕者 🫄
哺乳	哺乳 🤱
媽媽餵奶	媽媽餵奶 🤱
哺乳者	哺乳者 🧑‍🍼
餵奶人	餵奶人 🧑‍🍼
媽媽餵養	媽媽餵養 🧑‍🍼
劍擊	劍擊 🤺
運動劍	運動劍 🤺
競技劍	競技劍 🤺
賽馬	賽馬 🏇
馬術	馬術 🏇
馬賽	馬賽 🏇
滑雪者	滑雪者 ⛷️
冬季運動	冬季運動 ⛷️
單板滑雪	單板滑雪 🏂
打高爾夫	打高爾夫 🏌️
高球	高球 🏌️
衝浪	衝浪 🏄
衝浪者	衝浪者 🏄
海上運動	海上運動 🏄
划船	划船 🚣
划艇	划艇 🚣
水上運動	水上運動 🚣
游泳	游泳 🏊
水中運動	水中運動 🏊
游泳者	游泳者 🏊
打球	打球 ⛹️
彈球	彈球 ⛹️
舉重	舉重 🏋️
重訓	重訓 🏋️
健身	健身 🏋️ 🏃‍♂️ 💪
騎車	騎車 🚴 🛵
騎腳踏車	騎腳踏車 🚴
自行車	自行車 🚴 🚵 🚲
山地自行車	山地自行車 🚵
運動騎行	運動騎行 🚵
空翻	空翻 🤸
翻滾	翻滾 🤸
體操	體操 🤸
摔跤	摔跤 🤼
角力	角力 🤼
體育摔跤	體育摔跤 🤼
水球	水球 🤽
水上手球	水上手球 🤽
游泳球	游泳球 🤽
手球	手球 🤾
球類運動	球類運動 🤾
手掌球	手掌球 🤾
玩雜耍	玩雜耍 🤹
造型球	造型球 🤹
演藝	演藝 🤹
說話頭	說話頭 🗣️
語音頭	語音頭 🗣️
發言	發言 🗣️
單人影	單人影 👤
人影	人影 👤
單人	單人 👤
雙人影	雙人影 👥
群人影	群人影 👥
群像	群像 👥
擁抱	擁抱 🫂 🤗 🤭 🫢 🫣 🤫 🤔 🫡
擁人	擁人 🫂
抱抱	抱抱 🫂
家庭	家庭 👪 🚪 🛗 🪞 🪟 🛏️ 🛋️ 🪑 🚽 🪠 🚿 🛁 🪤 🪒 🧴 🧷 🧹 🧺 🧻 🪣 🧼 🫧 🪥 🧽 🧯 🛒
一家	一家 👪
家人	家人 👪 🧑‍🤝‍🧑 👭 👫 👬 💏 💑 👨‍👩‍👧‍👦 🏠 ❤️
雙親一孩	雙親一孩 🧑‍🧑‍🧒
雙大一小	雙大一小 🧑‍🧑‍🧒
一家三口	一家三口 🧑‍🧑‍🧒
雙親二孩	雙親二孩 🧑‍🧑‍🧒‍🧒
一家四口	一家四口 🧑‍🧑‍🧒‍🧒
四口之家	四口之家 🧑‍🧑‍🧒‍🧒
單親一孩	單親一孩 🧑‍🧒
一大一小	一大一小 🧑‍🧒
一家兩口	一家兩口 🧑‍🧒
單親二孩	單親二孩 🧑‍🧒‍🧒
三口之家	三口之家 🧑‍🧒‍🧒
一大兩小	一大兩小 🧑‍🧒‍🧒
踩印	踩印 👣
指紋	指紋 🫆
手印	手印 🫆
身份印	身份印 🫆
嬰兒	嬰兒 👶 🚼
小嬰	小嬰 👶
嬰寶	嬰寶 👶
孩子	孩子 🧒
小孩	小孩 🧒 👶 🧸
小童	小童 🧒
男孩	男孩 👦
小男	小男 👦
男童	男童 👦
女孩	女孩 👧
小女	小女 👧
女童	女童 👧
成人	成人 🧑
人類	人類 🧑 👶 🧒 👦 👧 👱 🧔 🧑‍🦰 🧑‍🦱 🧑‍🦳 🧑‍🦲 🧓 👴 👵
人物	人物 🧑 👶 🧒 👦 👧 👱 🧔 🧑‍🦰 🧑‍🦱 🧑‍🦳 🧑‍🦲 🧓 👴 👵
金髮	金髮 👱
金髮人	金髮人 👱
黃髮	黃髮 👱
鬍子	鬍子 🧔
鬍鬚	鬍鬚 🧔
鬍男	鬍男 🧔
紅髮	紅髮 🧑‍🦰
紅髮人	紅髮人 🧑‍🦰
紅頭	紅頭 🧑‍🦰
卷髮	卷髮 🧑‍🦱
捲髮	捲髮 🧑‍🦱
卷頭	卷頭 🧑‍🦱
白髮	白髮 🧑‍🦳
白頭	白頭 🧑‍🦳
老白	老白 🧑‍🦳
光頭	光頭 🧑‍🦲
禿頭	禿頭 🧑‍🦲
光頂	光頂 🧑‍🦲
老人	老人 🧓
長者	長者 🧓
年長	年長 🧓
老翁	老翁 👴
老爺	老爺 👴
爺爺	爺爺 👴
老嫗	老嫗 👵
老奶	老奶 👵
奶奶	奶奶 👵
貓笑	貓笑 😺 😼 😸 😹 😻 😽 🙀 😿 😾
微笑	微笑 😺 😸 😻 😗 ☺️ 😚 😙 🥲 😕 🫤 😟 🙁 ☹️ 😮 😯 😲 😳 🥺 🥹 😦 😧 😨 😰 😥 😢 😭 😱 😖 😣 😞 😓 😩 😫 🥱 😏 🙂 😊 😀 😃 😄 😁 😆 😅 🤣 😂 🙃 🫠 😉 😇
開心	開心 😺 😸 😹 🥰 😍 🤩 ☺️ 😀 😃 😁 💛 😄 😆 😅 🤣 😂 🙂 🙃 🫠 😉 😊 😇
貓眼	貓眼 😸
貓哭	貓哭 😹
哭笑	哭笑 😹 🥲 😂
貓愛	貓愛 😻 😺 😸 😹 😼 😽 🙀 😿 😾
心愛	心愛 😻 🥰 😍 🤩 😘 😗 ☺️ 😚 😙 🥲
鬼笑	鬼笑 😼
狡笑	狡笑 😼
貓吻	貓吻 😽
親吻	親吻 😽 💋 😘 😗 😙
可愛	可愛 😽
貓累	貓累 🙀
疲憊	疲憊 🙀 😓 😩 😮‍💨
無力	無力 🙀 🫠 🤮 😵 🩶
貓泣	貓泣 😿
哭泣	哭泣 😿 🥲 🥹 😢
悲傷	悲傷 😿 ☹️ 🖤
貓怒	貓怒 😾
鳴不平	鳴不平 😾
唇印	唇印 💋
百分	百分 💯 💋 💢 💥 💫 💦 💨 🕳️ 💬 👁️‍🗨️ 🗨️ 🗯️ 💭 💤
完美	完美 💯
怒符	怒符 💢 💋 💯 💥 💫 💦 💨 🕳️ 💬 👁️‍🗨️ 🗨️ 🗯️ 💭 💤
碰撞	碰撞 💥
爆炸	爆炸 💥
眩暈	眩暈 💫 😵
頭暈	頭暈 💫 🥴
汗滴	汗滴 💦
汗水	汗水 💦
飛奔	飛奔 💨
逃跑	逃跑 💨
消失	消失 🕳️
氣泡	氣泡 💬
談話	談話 💬
眼泡	眼泡 👁️‍🗨️
思考	思考 👁️‍🗨️ 🤔
左泡	左泡 🗨️
討論	討論 🗨️ 🗣️ 💬
怒泡	怒泡 🗯️
思泡	思泡 💭
想法	想法 💭
睡聲	睡聲 💤
打鼾	打鼾 💤
心笑	心笑 🥰
愛心	愛心 🥰 😍 😘 😗 😚 😙 💗 ❤️ 💌 💘 💝 💖 💓 💞 💕 💟 ❣️ 💔 ❤️‍🔥 ❤️‍🩹 🩷 🧡 💛 💚 💙 🩵 💜 🤎 🖤 🩶 🤍
喜愛	喜愛 🥰 😗 ❤️ 😍 💖
喜歡	喜歡 🥰 😍 ❤️
心眼	心眼 😍
迷戀	迷戀 😍
星眼	星眼 🤩
驚喜	驚喜 🤩 🎁 😲
欣喜	欣喜 🤩
激動	激動 🤩 💓
飛吻	飛吻 😘
送吻	送吻 😘
戀愛	戀愛 😘 🥰 💘 💏
吻	吻 😗
笑臉	笑臉 ☺️ 😀 😃 😄 😁 😆 😅 🤣 😂 🙂 🙃 🫠 😉 😊 😇
喜悅	喜悅 ☺️ 😙 💛
高興	高興 ☺️ 😄 😃 😆 🎉
親臉	親臉 😚
甜吻	甜吻 😚
熱吻	熱吻 😚
笑吻	笑吻 😙
淚笑	淚笑 🥲
感動	感動 🥲 ❣️ 🥹 😢 😭 ❤️
困惑	困惑 😕 😖 🫤 😟 🙁 ☹️ 😮 😯 😲 😳 🥺 🥹 😦 😧 😨 😰 😥 😢 😭 😱 😣 😞 😓 😩 😫 🥱
安靜	安靜 😕 🫤 😟 🙁 ☹️ 😮 😯 😲 😳 🥺 🥹 😦 😧 😨 😰 😥 😢 😭 😱 😖 😣 😞 😓 😩 😫 🥱 🤫 🤐
迷茫	迷茫 😕 😖 😶‍🌫️ 😵
疑問	疑問 😕 🤨 ⁉️ ❓ ❔
斜嘴	斜嘴 🫤
疑惑	疑惑 🫤 🤔 ❓ 🧐
尷尬	尷尬 🫤 😅
擔心	擔心 😟 😰
焦慮	焦慮 😟 😰
忐忑	忐忑 😟
微皺	微皺 🙁
不開心	不開心 🙁 😒
哀愁	哀愁 🙁
憂愁	憂愁 ☹️
張嘴	張嘴 😮 😃
驚訝	驚訝 😮 😯 😲 🤭 🫢 ❗ 😕 🫤 😟 🙁 ☹️ 😳 🥺 🥹 😦 😧 😨 😰 😥 😢 😭 😱 😖 😣 😞 😓 😩 😫 🥱 🤗 🫣 🤫 🤔 🫡
驚奇	驚奇 😮
閉嘴	閉嘴 😯 🤫 🤐 🙊
吃驚	吃驚 😲 🫨
震驚	震驚 😲
臉紅	臉紅 😳
害羞	害羞 😳 🤭 😅 😊 🙈
見羞	見羞 😳
哀求	哀求 🥺
可憐	可憐 🥺
苦苦	苦苦 🥺
忍淚	忍淚 🥹
淚水	淚水 🥹 😥 😢
張皺	張皺 😦
不悅	不悅 😦 😒
驚嚇	驚嚇 😦 🫨
痛苦	痛苦 😧 😬 🤮 😵 😖 😩 😫
心痛	心痛 😧
不安	不安 😧
害怕	害怕 😨
恐懼	恐懼 😨 😱
嚇到	嚇到 😨 🫢 😱 👻 🫣
流汗	流汗 😰
悲鬆	悲鬆 😥
傷心	傷心 😢 💔 😞
大哭	大哭 😭
哭喊	哭喊 😭
失落	失落 😭
尖叫	尖叫 😱
驚叫	驚叫 😱
混亂	混亂 😖 😵
堅持	堅持 😣
耐心	耐心 😣
堅韌	堅韌 😣
失望	失望 😞
沮喪	沮喪 😞 😓
難過	難過 😞 😢 😔 😿
憂鬱	憂鬱 😓 🩶
精疲力盡	精疲力盡 😩
劳累	劳累 😩
疲倦	疲倦 😫 🥱 😪
疲乏	疲乏 😫
疲勞	疲勞 😫 🫩 😩 🥱 😪
打哈	打哈 🥱
嬉笑	嬉笑 🥱
糞便	糞便 💩
屎	屎 💩
屁	屁 💩
大便	大便 💩
噗臭	噗臭 💩
搞笑	搞笑 🤡
滑稽	滑稽 🤡 😆 😛 😝
逗趣	逗趣 🤡
惡鬼	惡鬼 👹
鬼怪	鬼怪 👹 👻
魔物	魔物 👹
怪臉	怪臉 👹
妖怪	妖怪 👺
天狗	天狗 👺
紅臉	紅臉 👺
妖魔	妖魔 👺
魔怪	魔怪 👺
鬼魂	鬼魂 👻
幽靈	幽靈 👻
靈體	靈體 👻
鬼	鬼 👻 💀
外星人	外星人 👽
不明生物	不明生物 👽
外星	外星 👽
怪人	怪人 👽
異形	異形 👽
怪獸	怪獸 👾
外星怪	外星怪 👾
小兵	小兵 👾
機器人	機器人 🤖
機械人	機械人 🤖
機器	機器 🤖
機器頭	機器頭 🤖
人工智慧	人工智慧 🤖
裝酷	裝酷 😎
耍帥	耍帥 😎
酷哥	酷哥 😎
太陽眼鏡	太陽眼鏡 😎
書呆	書呆 🤓 😎 🧐
眼鏡仔	眼鏡仔 🤓
學霸	學霸 🤓
宅	宅 🤓
臉圓	臉圓 🤓
單鏡	單鏡 🧐
檢查	檢查 🧐 🛃
挑剔	挑剔 🧐
紳士	紳士 🧐
歡迎	歡迎 🤗
擁開	擁開 🤗
溫暖	溫暖 🤗 🧡 🤎
接納	接納 🤗
捂嘴	捂嘴 🤭 🫢
忍笑	忍笑 🤭
偷笑	偷笑 🤭
瞪眼	瞪眼 🫢
緊張	緊張 🫢 😰 😨 😱 😬
偷看	偷看 🫣
躲躲	躲躲 🫣
偷窺	偷窺 🫣
看你	看你 🫣
藏臉	藏臉 🫣
噓聲	噓聲 🤫
保密	保密 🤫 🙊
想	想 🤔
想想	想想 🤔
問號	問號 🤔 ⁉️ ❓ ❔
懷疑	懷疑 🤔 🤨
敬禮	敬禮 🫡
致意	致意 🫡
軍禮	軍禮 🫡
尊敬	尊敬 🫡
牛仔	牛仔 🤠 🥳 🥸
西部	西部 🤠
帽子	帽子 🤠
鄉村	鄉村 🤠
狂野	狂野 🤠
派對	派對 🥳 🤠 🥸 🎉 🎊 🍾
慶祝	慶祝 🥳 🎃 🎄 🎆 🎇 🧨 ✨ 🎈 🎉 🎊 🎋 🎍 🎎 🎏 🎐 🎑 🧧 🎀 🎁 🎗️ 🎟️ 🎫
狂歡	狂歡 🥳
舞會	舞會 🥳
嗨翻	嗨翻 🥳
偽裝	偽裝 🥸
變裝	變裝 🥸
臉譜	臉譜 🥸
隱藏	隱藏 🥸 🙈
神秘	神秘 🥸 💜
冒氣	冒氣 😤
氣噗	氣噗 😤
氣呼	氣呼 😤
呼氣	呼氣 😤
氣炸	氣炸 😤
憤怒	憤怒 😡 😤 😠 🤬 😈 👿 💀 ☠️
爆怒	爆怒 😡
火臉	火臉 😡
怒氣	怒氣 😡
火大	火大 😡 🔥 😤
不爽	不爽 😠 🙄
氣臉	氣臉 😠
惱	惱 😠
怒	怒 😠
咒罵	咒罵 🤬
髒話	髒話 🤬
怒罵	怒罵 🤬
爆粗	爆粗 🤬
罵人	罵人 🤬
惡笑	惡笑 😈
壞壞	壞壞 😈
調皮	調皮 😈 🙃
邪惡	邪惡 😈
惡魔	惡魔 😈
惡怒	惡怒 👿
魔怒	魔怒 👿
惡臉	惡臉 👿
暴走	暴走 👿
魔頭	魔頭 👿
骷髏	骷髏 💀 ☠️
死亡	死亡 💀 ☠️
頭骨	頭骨 💀
中毒	中毒 ☠️
危險	危險 ☠️ ⚠️ ☢️ ☣️ 🚸 ⛔ 🚫 🚳 🚭 🚯 🚱 🚷 📵 🔞
沉默	沉默 🤐 😶 🫥 🩶 🙊
默不作聲	默不作聲 🤐
忍住	忍住 🤐
挑眉	挑眉 🤨 😉
看不慣	看不慣 🤨
不解	不解 🤨
平臉	平臉 😐 🤐 🤨 😑 😶 🫥 😶‍🌫️ 😏 😒 🙄 😬 😮‍💨 🤥 🫨 🙂‍↔️ 🙂‍↕️
無表情	無表情 😐 😑 🤐 🤨 😶 🫥 😶‍🌫️ 😏 😒 🙄 😬 😮‍💨 🤥 🫨 🙂‍↔️ 🙂‍↕️
冷靜	冷靜 😐 🧘 🫥
不動	不動 😐
不變	不變 😐
冷漠	冷漠 😑
無語	無語 😑 🫥 🙃
面無表情	面無表情 😑
無嘴	無嘴 😶
不語	不語 😶
沒話	沒話 😶
說不出	說不出 😶
虛線	虛線 🫥
隱瞞	隱瞞 🫥
看不清	看不清 🫥
雲臉	雲臉 😶‍🌫️
模糊	模糊 😶‍🌫️
漫遊	漫遊 😶‍🌫️
迷霧	迷霧 😶‍🌫️
得意	得意 😏
質疑	質疑 😏
傻笑	傻笑 😏
斜視	斜視 😏
不耐煩	不耐煩 😒
無聊	無聊 😒 😔 🥱 😐 💤
厭煩	厭煩 😒
翻眼	翻眼 🙄
白眼	白眼 🙄
看不起	看不起 🙄
齜牙	齜牙 😬
不舒服	不舒服 😬 🤢
累	累 😬 😴 🥱 😪 😩
見鬼	見鬼 😬
吐氣	吐氣 😮‍💨
深呼吸	深呼吸 😮‍💨
說謊	說謊 🤥
狡猾	狡猾 🤥
虛偽	虛偽 🤥
騙人	騙人 🤥
假話	假話 🤥
震臉	震臉 🫨
震動	震動 🫨 📳
錯愕	錯愕 🫨
左右	左右 🙂‍↔️ ↔️
不同意	不同意 🙂‍↔️
否定	否定 🙂‍↔️ 🙂‍↕️
頭搖	頭搖 🙂‍↔️
上下	上下 🙂‍↕️ ↕️
頭晃	頭晃 🙂‍↕️
舒適	舒適 😌
安心	安心 😌
解脫	解脫 😌
輕鬆	輕鬆 😌
沉思	沉思 😔
惆悵	惆悵 😔
深思	深思 😔
慍	慍 😔
睏臉	睏臉 😪 😌 😔 🤤 😴 🫩
想睡	想睡 😪
打哈欠	打哈欠 😪
昏沉	昏沉 😪 🫩
流口水	流口水 🤤
垂涎	垂涎 🤤
睡意	睡意 🤤
沉睡	沉睡 🤤
鬆弛	鬆弛 🤤
呼吸安穩	呼吸安穩 😴
安眠	安眠 😴
夢鄉	夢鄉 😴
熟睡	熟睡 😴
黑眼圈	黑眼圈 🫩
累樣	累樣 🫩
沒精神	沒精神 🫩
笑	笑 😀
嘴角	嘴角 😀
樂臉	樂臉 😀 😁
大笑	大笑 😃 😆 🤣
樂呵	樂呵 😃
笑眼	笑眼 😃 😄
笑彎	笑彎 😄
樂觀	樂觀 😄
暖笑	暖笑 😄 😊
明亮	明亮 😄
露齒	露齒 😁
笑齒	笑齒 😁
熱情	熱情 😁 ❤️
笑眯	笑眯 😆
閉眼	閉眼 😆
哈哈	哈哈 😆 🤪 😂 🤣 😹
苦笑	苦笑 😅
笑汗	笑汗 😅
笑翻	笑翻 🤣
滾地	滾地 🤣
爆笑	爆笑 🤣
狂笑	狂笑 🤣 🤪
笑哭	笑哭 😂
開懷	開懷 😂
喜極而泣	喜極而泣 😂
淡笑	淡笑 🙂
禮貌	禮貌 🙂
輕笑	輕笑 🙂
善意	善意 🙂
倒笑	倒笑 🙃
反笑	反笑 🙃
黑笑	黑笑 🙃
融化	融化 🫠
笑融	笑融 🫠
垮臉	垮臉 🫠
累笑	累笑 🫠
眨眼	眨眼 😉
調情	調情 😉
暗示	暗示 😉
俏皮	俏皮 😉 😜
親切	親切 😊
守禮	守禮 😊
善良	善良 😊 🤍
光環	光環 😇
善笑	善笑 😇
無邪	無邪 😇
清純	清純 😇
美味	美味 😋 😛 😜 🤪 😝 🤑
舌臉	舌臉 😋 😛
滋味	滋味 😋
嚐鮮	嚐鮮 😋
餓狼	餓狼 😋
搞怪	搞怪 😛 😜 🤪 😝 😋 🤑
眨舌	眨舌 😛 😜
鬼臉	鬼臉 😛
嬉皮	嬉皮 😜
搗蛋	搗蛋 😜
蠢臉	蠢臉 🤪
疯狂	疯狂 🤪
笑舌	笑舌 😝
舔舌	舔舌 😝
刺眼	刺眼 😝
錢嘴	錢嘴 🤑
貪心	貪心 🤑
錢眼	錢眼 🤑
哇塞	哇塞 🤑
財富	財富 🤑 💰 🪙 💴 💵 💶 💷 💸 💳 🧾 💹
口罩	口罩 😷
防疫	防疫 😷 🧴 🧼
生病	生病 😷 🤧 🤒 🥴
醫療	醫療 😷 ⚕️ 💉 🩸 💊 🩹 🩼 🩺 🩻
疾病	疾病 😷
發燒	發燒 🤒 🌡️ 🔥
病人	病人 🤒
量體溫	量體溫 🤒
不適	不適 🤒 🥴 😷 🤕 🤢 🤮 🤧 🥵 🥶 😵 😵‍💫 🤯
虛弱	虛弱 🤒
包頭	包頭 🤕
傷痛	傷痛 🤕
癒合	癒合 🤕
包紮	包紮 🤕
受傷	受傷 🤕
噁心	噁心 🤢 🤮 😷 🤒 🤕 🤧 🥵 🥶 🥴 😵 😵‍💫 🤯
想吐	想吐 🤢 🤮
嘔吐	嘔吐 🤢 🤮
暈眩	暈眩 🤢 😵‍💫
打噴嚏	打噴嚏 🤧
感冒	感冒 🤧 🤒 💊
傷風	傷風 🤧
痰	痰 🤧
熱臉	熱臉 🥵
出汗	出汗 🥵
熱浪	熱浪 🥵
中暑	中暑 🥵
燥熱	燥熱 🥵
冷臉	冷臉 🥶
冷凍	冷凍 🥶
寒冷	寒冷 🥶
寒氣	寒氣 🥶
冒冷汗	冒冷汗 🥶
暈臉	暈臉 🥴
親暈	親暈 🥴
迷糊	迷糊 🥴
旋眼	旋眼 😵‍💫
頭昏	頭昏 😵‍💫
嚴重痛苦	嚴重痛苦 😵‍💫
昏厥	昏厥 😵‍💫
爆頭	爆頭 🤯
智力爆發	智力爆發 🤯
精神崩潰	精神崩潰 🤯
崩潰	崩潰 🤯
思考過載	思考過載 🤯
情書	情書 💌
愛情	愛情 💌 ❤️ 💕 💑
表達	表達 💌 ‼️ ⁉️ ❓ ❔ ❕ ❗ 〰️
情感	情感 💌 💋 💯 💢 💥 💫 💦 💨 🕳️ 💬 👁️‍🗨️ 🗨️ 🗯️ 💭 💤 🥰 😍 🤩 😘 😗 ☺️ 😚 😙 🥲 💘 💝 💖 💗 💓 💞 💕 💟 ❣️ 💔 ❤️‍🔥 ❤️‍🩹 ❤️ 🩷 🧡 💛 💚 💙 🩵 💜 🤎 🖤 🩶 🤍
信	信 💌
箭心	箭心 💘
愛戀	愛戀 💘 💕
打中	打中 💘
心動	心動 💘 ❣️ 💓 ❤️‍🔥
禮心	禮心 💝
心結	心結 💝
祝福	祝福 💝
心意	心意 💝
閃心	閃心 💖
愛光	愛光 💖
亮心	亮心 💖
心願	心願 💖
長心	長心 💗
漸長	漸長 💗
心生	心生 💗
跳心	跳心 💓
心跳	心跳 💓
轉心	轉心 💞
旋轉愛	旋轉愛 💞
心轉	心轉 💞
雙心	雙心 💕
配對	配對 💕
裝心	裝心 💟
心裝	心裝 💟
修飾	修飾 💟
心情	心情 💟
驚心	驚心 ❣️
心急	心急 ❣️
碎心	碎心 💔
破碎	破碎 💔
心傷	心傷 💔
火心	火心 ❤️‍🔥
熾愛	熾愛 ❤️‍🔥
激情	激情 ❤️‍🔥
燃燒	燃燒 ❤️‍🔥
補心	補心 ❤️‍🩹
治癒	治癒 ❤️‍🩹
心痊	心痊 ❤️‍🩹
愈合	愈合 ❤️‍🩹
真愛	真愛 ❤️
粉心	粉心 🩷
柔情	柔情 🩷
愛意	愛意 🩷 🥰 😍 🤩 😘 😗 ☺️ 😚 😙 🥲
暖心	暖心 🩷
橙心	橙心 🧡
快樂	快樂 🧡
友誼	友誼 🧡
黃心	黃心 💛
光明	光明 💛
綠心	綠心 💚
自然	自然 💚 🏞️
希望	希望 💚
生命	生命 💚
藍心	藍心 💙
寧靜	寧靜 💙
心安	心安 💙 🩵
淡藍	淡藍 🩵
寧心	寧心 🩵
平和	平和 🩵
紫心	紫心 💜
優雅	優雅 💜
高貴	高貴 💜
棕心	棕心 🤎
穩重	穩重 🤎
誠懇	誠懇 🤎
黑心	黑心 🖤 😈
黑暗	黑暗 🖤
空虛	空虛 🖤
灰心	灰心 🩶
白心	白心 🤍
純潔	純潔 🤍
平靜	平靜 🤍 ☮️
遮眼	遮眼 🙈 🙉 🙊
不看	不看 🙈
看不見	看不見 🙈
忽視	忽視 🙈
遮耳	遮耳 🙉 🙈 🙊
不聽	不聽 🙉
聽不見	聽不見 🙉
忽聽	忽聽 🙉
置之不理	置之不理 🙉
遮嘴	遮嘴 🙊
不說	不說 🙊
大寫字母	大寫字母 🔠
拉丁大寫	拉丁大寫 🔠
字母	字母 🔠 🔡 🔤 🔢 🔣 🅰️ 🆎 🅱️ 🆑 🆒 🆓 ℹ️ 🆔 Ⓜ️ 🆕 🆖 🅾️ 🆗 🅿️ 🆘 🆙 🆚 🈁 🈂️ 🈷️ 🈶 🈯 🉐 🈹 🈚 🈲 🉑 🈸 🈴 🈳 ㊗️ ㊙️ 🈺 🈵
小寫字母	小寫字母 🔡
拉丁小寫	拉丁小寫 🔡
數字	數字 🔢 🔠 🔡 🔣 🔤 🅰️ 🆎 🅱️ 🆑 🆒 🆓 ℹ️ 🆔 Ⓜ️ 🆕 🆖 🅾️ 🆗 🅿️ 🆘 🆙 🆚 🈁 🈂️ 🈷️ 🈶 🈯 🉐 🈹 🈚 🈲 🉑 🈸 🈴 🈳 ㊗️ ㊙️ 🈺 🈵
數字鍵	數字鍵 🔢
數字輸入	數字輸入 🔢
符號	符號 🔣 ✖️ ➕ ➖ ➗ 🟰 ♾️ ⚕️ ♻️ ⚜️ 🔱 📛 🔰 ⭕ ✅ ☑️ ✔️ ❌ ❎ ➰ ➿ 〽️ ✳️ ✴️ ❇️ ©️ ®️ ™️ 🫟 ‼️ ⁉️ ❓ ❔ ❕ ❗ 〰️
符號鍵	符號鍵 🔣
輸入符號	輸入符號 🔣
拉丁字母	拉丁字母 🔤
輸入	輸入 🔤 ⌨️ 🎛️
A型	A型 🅰️
血型A	血型A 🅰️
A	A 🅰️
AB型	AB型 🆎
血型AB	血型AB 🆎
AB	AB 🆎
B型	B型 🅱️
血型B	血型B 🅱️
B	B 🅱️
CL	CL 🆑
按鍵CL	按鍵CL 🆑
符號CL	符號CL 🆑
酷	酷 🆒
按鍵COOL	按鍵COOL 🆒
符號COOL	符號COOL 🆒
免費	免費 🆓 🈚
按鍵FREE	按鍵FREE 🆓
符號FREE	符號FREE 🆓
信息	信息 ℹ️
資訊	資訊 ℹ️ 📰
符號信息	符號信息 ℹ️
身份	身份 🆔 🧑‍⚕️ 🧑‍🎓 🧑‍🏫 🧑‍⚖️ 🧑‍🌾 🧑‍🍳 🧑‍🔧 🧑‍🏭 🧑‍💼 🧑‍🔬 🧑‍💻 🧑‍🎤 🧑‍🎨 🧑‍✈️ 🧑‍🚀 🧑‍🚒 👮 🕵️ 💂 🥷 👷 🫅 🤴 👸 👳 👲 🧕 🤵 👰 🤰 🫃 🫄 🤱 🧑‍🍼
按鍵ID	按鍵ID 🆔
符號ID	符號ID 🆔
圈M	圈M Ⓜ️
符號M	符號M Ⓜ️
圈形M	圈形M Ⓜ️
新	新 🆕
按鍵NEW	按鍵NEW 🆕
符號NEW	符號NEW 🆕
NG	NG 🆖
按鍵NG	按鍵NG 🆖
符號NG	符號NG 🆖
O型	O型 🅾️
血型O	血型O 🅾️
O	O 🅾️
按鍵OK	按鍵OK 🆗
符號OK	符號OK 🆗
P	P 🅿️
按鍵P	按鍵P 🅿️
符號P	符號P 🅿️
求救	求救 🆘
按鍵SOS	按鍵SOS 🆘
符號SOS	符號SOS 🆘
按鍵UP	按鍵UP 🆙
符號UP	符號UP 🆙
對比	對比 🆚
按鍵VS	按鍵VS 🆚
符號VS	符號VS 🆚
這裡	這裡 🈁
按鍵這裡	按鍵這裡 🈁
符號這裡	符號這裡 🈁
服務費	服務費 🈂️
按鍵服務費	按鍵服務費 🈂️
符號服務費	符號服務費 🈂️
月費	月費 🈷️
按鍵月費	按鍵月費 🈷️
符號月費	符號月費 🈷️
收費	收費 🈶
按鍵收費	按鍵收費 🈶
符號收費	符號收費 🈶
預留	預留 🈯
按鍵預留	按鍵預留 🈯
符號預留	符號預留 🈯
優惠	優惠 🉐
按鍵優惠	按鍵優惠 🉐
符號優惠	符號優惠 🉐
折扣	折扣 🈹
按鍵折扣	按鍵折扣 🈹
符號折扣	符號折扣 🈹
按鍵免費	按鍵免費 🈚
符號免費	符號免費 🈚
禁止	禁止 🈲 ⛔ 🚫
按鍵禁止	按鍵禁止 🈲
符號禁止	符號禁止 🈲
可接受	可接受 🉑
按鍵可接受	按鍵可接受 🉑
符號可接受	符號可接受 🉑
申請	申請 🈸
按鍵申請	按鍵申請 🈸
符號申請	符號申請 🈸
合格	合格 🈴
按鍵合格	按鍵合格 🈴
符號合格	符號合格 🈴
空缺	空缺 🈳
按鍵空缺	按鍵空缺 🈳
符號空缺	符號空缺 🈳
恭喜	恭喜 ㊗️
按鍵恭喜	按鍵恭喜 ㊗️
符號恭喜	符號恭喜 ㊗️
秘密	秘密 ㊙️
按鍵秘密	按鍵秘密 ㊙️
符號秘密	符號秘密 ㊙️
營業	營業 🈺
按鍵營業	按鍵營業 🈺
符號營業	符號營業 🈺
滿員	滿員 🈵
按鍵滿員	按鍵滿員 🈵
符號滿員	符號滿員 🈵
上升	上升 ⬆️ 🔼
上	上 ⬆️
右上	右上 ↗️
向右上	向右上 ↗️
右上角	右上角 ↗️
右移	右移 ➡️
右	右 ➡️
右下	右下 ↘️
向右下	向右下 ↘️
右下角	右下角 ↘️
下降	下降 ⬇️ 🔽
下	下 ⬇️
左下	左下 ↙️
向左下	向左下 ↙️
左下角	左下角 ↙️
左移	左移 ⬅️
左	左 ⬅️
左上	左上 ↖️
向左上	向左上 ↖️
左上角	左上角 ↖️
垂直	垂直 ↕️
垂直方向	垂直方向 ↕️
水平	水平 ↔️
水平方向	水平方向 ↔️
右轉左	右轉左 ↩️
向左轉	向左轉 ↩️
左彎	左彎 ↩️
右轉	右轉 ↩️
左轉右	左轉右 ↪️
向右轉	向右轉 ↪️
右彎	右彎 ↪️
左轉	左轉 ↪️
右轉上	右轉上 ⤴️
向上轉	向上轉 ⤴️
上彎	上彎 ⤴️
右轉下	右轉下 ⤵️
向下轉	向下轉 ⤵️
下彎	下彎 ⤵️
順時針	順時針 🔃
旋轉	旋轉 🔃 🔄
順時針旋轉	順時針旋轉 🔃
逆時針	逆時針 🔄
逆時針旋轉	逆時針旋轉 🔄
返回	返回 🔙 ⬅️
後退	後退 🔙 ◀️
回去	回去 🔙
撤回	撤回 🔙
結束	結束 🔚 ⏹️
終止	終止 🔚
終點	終點 🔚
完結	完結 🔚
開啟	開啟 🔛
啟動	啟動 🔛
開始	開始 🔛 ▶️ 🟢
開始運作	開始運作 🔛
即將	即將 🔜
快速	快速 🔜 ⏫ ⏬
即刻	即刻 🔜
立刻	立刻 🔜
頂部	頂部 🔝
上方	上方 🔝
最上	最上 🔝
隨機播放	隨機播放 🔀
隨機	隨機 🔀
音樂	音樂 🔀 🔁 ▶️ ⏩ ⏭️ ⏯️ ◀️ ⏪ ⏮️ 🔼 ⏫ 🔽 ⏬ ⏸️ ⏹️ ⏺️ ⏏️ 🎼 🎵 🎶 🎙️ 🎚️ 🎛️ 🎤 🎧 📻 🔂 🎦 🔅 🔆 📶 🛜 📳 📴
隨機曲目	隨機曲目 🔀
重複	重複 🔁
循環	循環 🔁 🔂 ♻️
播放循環	播放循環 🔁
單曲重複	單曲重複 🔂
單曲	單曲 🔂
播放單曲	播放單曲 🔂
播放	播放 ▶️
播放中	播放中 ▶️
快進	快進 ⏩
前進	前進 ⏩
快速播放	快速播放 ⏩
下一曲	下一曲 ⏭️
下一	下一 ⏭️
下一首	下一首 ⏭️
播放暫停	播放暫停 ⏯️
暫停	暫停 ⏯️ ⏸️
停止播放	停止播放 ⏯️ ⏹️
倒退	倒退 ◀️ ⏪
回放	回放 ◀️
快退	快退 ⏪
快速回放	快速回放 ⏪
上一曲	上一曲 ⏮️
上一	上一 ⏮️
上一首	上一首 ⏮️
音量增大	音量增大 🔼
快速向上	快速向上 ⏫
音量快速增大	音量快速增大 ⏫
音量減少	音量減少 🔽
快速向下	快速向下 ⏬
音量快速減少	音量快速減少 ⏬
中斷播放	中斷播放 ⏸️
錄音	錄音 ⏺️
錄製	錄製 ⏺️
錄音中	錄音中 ⏺️
彈出	彈出 ⏏️
退出	退出 ⏏️
移除	移除 ⏏️
電影院	電影院 🎦
影片	影片 🎦
視頻	視頻 🎦 🎥 🎞️ 📽️ 🎬 📺 📷 📸 📹 📼 🔍 🔎 🕯️ 💡 🔦 🏮 🪔 🔀 🔁 🔂 ▶️ ⏩ ⏭️ ⏯️ ◀️ ⏪ ⏮️ 🔼 ⏫ 🔽 ⏬ ⏸️ ⏹️ ⏺️ ⏏️ 🔅 🔆 📶 🛜 📳 📴
影像	影像 🎦
暗	暗 🔅
降低	降低 🔅
光線	光線 🔅 🔆
減光	減光 🔅
亮	亮 🔆
提高	提高 🔆
增光	增光 🔆
信號	信號 📶
網絡	網絡 📶 🛜
連接	連接 📶 🛜
信號強度	信號強度 📶
無線	無線 🛜
無線網絡	無線網絡 🛜
振動	振動 📳
振動模式	振動模式 📳
手機關閉	手機關閉 📴
關機	關機 📴
關閉狀態	關閉狀態 📴
貨幣兌換	貨幣兌換 💱
兌換	兌換 💱
金錢	金錢 💱 💲 💰 🪙 💴 💵 💶 💷 💸 💳 🧾 💹
交易	交易 💱
匯率	匯率 💱
美金	美金 💲
美金符號	美金符號 💲
女性	女性 ♀️ ♂️ ⚧️
女	女 ♀️
女士	女士 ♀️
男性	男性 ♂️ ♀️ ⚧️
男	男 ♂️
男士	男士 ♂️
跨性別	跨性別 ⚧️
變性	變性 ⚧️
性別	性別 ⚧️ ♀️ ♂️
紅圈	紅圈 🔴
圓形	圓形 🔴 🟠 🟡 🟢 🔵 🟣 🟤 ⚫ ⚪ 🔘 ⭕
紅色	紅色 🔴 🟥 🔺 🔻
橙圈	橙圈 🟠
橙色	橙色 🟠 🟧 🔶 🔸
黃圈	黃圈 🟡
黃色	黃色 🟡 🟨
綠圈	綠圈 🟢
綠色	綠色 🟢 🟩
藍圈	藍圈 🔵
藍色	藍色 🔵 🟦 🔷 🔹
紫圈	紫圈 🟣
紫色	紫色 🟣 🟪
棕圈	棕圈 🟤
棕色	棕色 🟤 🟫
黑圈	黑圈 ⚫
黑色	黑色 ⚫ ⬛ ◼️ ◾ ▪️
白圈	白圈 ⚪
白色	白色 ⚪ ⬜ ◻️ ◽ ▫️
紅方塊	紅方塊 🟥
方形	方形 🟥 🟧 🟨 🟩 🟦 🟪 🟫 ⬛ ⬜ ◼️ ◻️ ◾ ◽ ▪️ ▫️ 🔳 🔲
橙方塊	橙方塊 🟧
黃方塊	黃方塊 🟨
綠方塊	綠方塊 🟩
藍方塊	藍方塊 🟦
紫方塊	紫方塊 🟪
棕方塊	棕方塊 🟫
黑大方塊	黑大方塊 ⬛
白大方塊	白大方塊 ⬜
黑中方塊	黑中方塊 ◼️
白中方塊	白中方塊 ◻️
黑小方塊	黑小方塊 ◾ ▪️
白小方塊	白小方塊 ◽ ▫️
橙大菱形	橙大菱形 🔶
菱形	菱形 🔶 🔷 🔸 🔹 💠
藍大菱形	藍大菱形 🔷
橙小菱形	橙小菱形 🔸
藍小菱形	藍小菱形 🔹
紅三角	紅三角 🔺
三角形	三角形 🔺 🔻
紅倒三角	紅倒三角 🔻
點菱形	點菱形 💠
點	點 💠
圓形按鈕	圓形按鈕 🔘
按鈕	按鈕 🔘 🔳 🔲 🖲️
白方形按鈕	白方形按鈕 🔳
黑方形按鈕	黑方形按鈕 🔲
鍵帽#	鍵帽# #️⃣
按鍵#	按鍵# #️⃣
符號#	符號# #️⃣
鍵帽*	鍵帽* *️⃣
按鍵*	按鍵* *️⃣
符號*	符號* *️⃣
鍵帽0	鍵帽0 0️⃣
按鍵0	按鍵0 0️⃣
符號0	符號0 0️⃣
鍵帽1	鍵帽1 1️⃣
按鍵1	按鍵1 1️⃣
符號1	符號1 1️⃣
鍵帽2	鍵帽2 2️⃣
按鍵2	按鍵2 2️⃣
符號2	符號2 2️⃣
鍵帽3	鍵帽3 3️⃣
按鍵3	按鍵3 3️⃣
符號3	符號3 3️⃣
鍵帽4	鍵帽4 4️⃣
按鍵4	按鍵4 4️⃣
符號4	符號4 4️⃣
鍵帽5	鍵帽5 5️⃣
按鍵5	按鍵5 5️⃣
符號5	符號5 5️⃣
鍵帽6	鍵帽6 6️⃣
按鍵6	按鍵6 6️⃣
符號6	符號6 6️⃣
鍵帽7	鍵帽7 7️⃣
按鍵7	按鍵7 7️⃣
符號7	符號7 7️⃣
鍵帽8	鍵帽8 8️⃣
按鍵8	按鍵8 8️⃣
符號8	符號8 8️⃣
鍵帽9	鍵帽9 9️⃣
按鍵9	按鍵9 9️⃣
符號9	符號9 9️⃣
鍵帽10	鍵帽10 🔟
按鍵10	按鍵10 🔟
符號10	符號10 🔟
乘	乘 ✖️
乘法	乘法 ✖️
計算	計算 ✖️ ➕ ➖ ➗ 🟰 ♾️
乘號	乘號 ✖️
加	加 ➕
加法	加法 ➕
加號	加號 ➕
減	減 ➖
減法	減法 ➖
減號	減號 ➖
除	除 ➗
除法	除法 ➗
除號	除號 ➗
等於	等於 🟰
相等	相等 🟰
平等	平等 🟰
等號	等號 🟰
無限	無限 ♾️
無窮	無窮 ♾️
無邊	無邊 ♾️
健康	健康 ⚕️ 💉 🩸 💊 🩹 🩼 🩺 🩻 💪 ❤️
醫學	醫學 ⚕️
醫學符號	醫學符號 ⚕️
回收	回收 ♻️
環保	環保 ♻️
回收符號	回收符號 ♻️
百合花	百合花 ⚜️
花形	花形 ⚜️
標誌	標誌 ⚜️ 🔱 🚧 🏁 🚩 🎌 🏴 🏳️ 🏳️‍🌈 🏳️‍⚧️ 🏴‍☠️ 🏧 🚮 🚰 ♿ 🚹 🚺 🚻 🚼 🚾 🛂 🛃 🛄 🛅
三叉戟	三叉戟 🔱
武器	武器 🔱
象徵	象徵 🔱
名牌	名牌 📛
標識	標識 📛 ⭕ ™️
名稱	名稱 📛
初學者	初學者 🔰
新手	新手 🔰
初級	初級 🔰
初學	初學 🔰
空心紅圈	空心紅圈 ⭕
圈形	圈形 ⭕
勾選	勾選 ✅
確認	確認 ✅ ✔️ ☑️
標記	標記 ✅ ✔️ ❌ 〽️ ✳️ ✴️ ©️ ®️ ™️ 🫟 📌 🖍️
勾號	勾號 ✅ ✔️
勾選框	勾選框 ☑️
確認框	確認框 ☑️
標記框	標記框 ☑️
核對	核對 ☑️
勾	勾 ✔️
錯誤	錯誤 ❌ 🧨 🐞 💥 🛑
叉號	叉號 ❌ ❎
叉按鈕	叉按鈕 ❎
錯誤按鈕	錯誤按鈕 ❎
標記按鈕	標記按鈕 ❎
彎曲環	彎曲環 ➰
環形	環形 ➰
彎曲	彎曲 ➰ ➿
圓環	圓環 ➰
雙彎曲環	雙彎曲環 ➿
雙環	雙環 ➿
雙圈	雙圈 ➿
部分交替	部分交替 〽️
交替	交替 〽️
分隔	分隔 〽️
八角星	八角星 ✳️ ✴️
星形	星形 ✳️ ✴️ ❇️ ✡️ 🔯
星號	星號 ✳️
星星	星星 ✴️ ⭐ 🌟 ✨
閃爍	閃爍 ❇️
版權	版權 ©️
著作權	著作權 ©️
版權符號	版權符號 ©️
註冊	註冊 ®️
商標	商標 ®️ ™️ 💈
註冊符號	註冊符號 ®️
商業	商業 ™️
濺射	濺射 🫟
飛濺	飛濺 🫟
水花	水花 🫟
雙驚嘆號	雙驚嘆號 ‼️
驚嘆號	驚嘆號 ‼️ ❕
強調	強調 ‼️
感嘆	感嘆 ‼️ ⁉️
驚嘆問號	驚嘆問號 ⁉️
紅問號	紅問號 ❓
詢問	詢問 ❓
白問號	白問號 ❔
無解	無解 ❔
白驚嘆號	白驚嘆號 ❕
表示驚訝	表示驚訝 ❕
紅驚嘆號	紅驚嘆號 ❗
強烈表達	強烈表達 ❗
波浪線	波浪線 〰️
波浪	波浪 〰️ 🌊
線條	線條 〰️
禮拜	禮拜 🛐
崇拜	崇拜 🛐
原子	原子 ⚛️
科學	科學 ⚛️ ⚗️ 🧪 🧫 🧬 🔬 🔭 📡
原子符號	原子符號 ⚛️
唵	唵 🕉️
印度教	印度教 🕉️ 🪯 🛕
禱告	禱告 🕉️
大衛星	大衛星 ✡️
猶太教	猶太教 ✡️ 🕎
法輪	法輪 ☸️
佛教	佛教 ☸️
輪子	輪子 ☸️
陰陽	陰陽 ☯️
太極	太極 ☯️
平衡	平衡 ☯️
十字架	十字架 ✝️
基督教	基督教 ✝️
信仰	信仰 ✝️ 🛐 ⚛️ 🕉️ ✡️ ☸️ ☯️ ☦️ ☪️ ☮️ 🕎 🔯 🪯
東正十字	東正十字 ☦️
東正教	東正教 ☦️
十字	十字 ☦️
星月	星月 ☪️ 🌔 🌖
伊斯蘭教	伊斯蘭教 ☪️ 🕌
和諧	和諧 ☮️
燭台	燭台 🕎
燈台	燈台 🕎
六角星	六角星 🔯
點星	點星 🔯
卡達	卡達 🪯
劍形	劍形 🪯
提款機	提款機 🏧
自動提款機	自動提款機 🏧
ATM	ATM 🏧
丟垃圾	丟垃圾 🚮
丟棄	丟棄 🚮
可飲水	可飲水 🚰
飲用水	飲用水 🚰
水源	水源 🚰 🚱
輪椅	輪椅 ♿ 🦽
無障礙	無障礙 ♿
殘疾	殘疾 ♿
男廁	男廁 🚹
男士廁所	男士廁所 🚹
男衛生間	男衛生間 🚹
女廁	女廁 🚺
女士廁所	女士廁所 🚺
女衛生間	女衛生間 🚺
公共廁所	公共廁所 🚻
洗手間	洗手間 🚻 🚾
嬰兒室	嬰兒室 🚼
嬰兒標誌	嬰兒標誌 🚼
衛生間	衛生間 🚾
護照	護照 🛂
海關	海關 🛂 🛃
出入境	出入境 🛂
申報	申報 🛃
行李	行李 🛄 🧳 🎒
提取	提取 🛄
行李提取	行李提取 🛄
寄存	寄存 🛅
行李寄存	行李寄存 🛅
存放	存放 🛅
警告	警告 ⚠️ 🚸 ⛔ 🚫 🚳 🚭 🚯 🚱 🚷 📵 🔞 ☢️ ☣️ 🚧 🚨
注意	注意 ⚠️ 🚸 ⛔ 🚫 🚳 🚭 🚯 🚱 🚷 📵 🔞 ☢️ ☣️ 📢 🔔
孩童	孩童 🚸
兒童	兒童 🚸
過馬路	過馬路 🚸
禁入	禁入 ⛔
不允許	不允許 🚫
禁止標誌	禁止標誌 🚫
禁止自行車	禁止自行車 🚳
禁止騎車	禁止騎車 🚳
禁止騎行	禁止騎行 🚳
禁止吸煙	禁止吸煙 🚭
禁煙	禁煙 🚭
吸煙區	吸煙區 🚭
禁止丟垃圾	禁止丟垃圾 🚯
禁止亂丟	禁止亂丟 🚯
垃圾區	垃圾區 🚯
非飲用水	非飲用水 🚱
不可飲用	不可飲用 🚱
禁止行人	禁止行人 🚷
禁止通行	禁止通行 🚷
行人區	行人區 🚷
禁止手機	禁止手機 📵
禁止使用手機	禁止使用手機 📵
手機禁用	手機禁用 📵
未滿十八	未滿十八 🔞
禁止未成年人	禁止未成年人 🔞
成年限制	成年限制 🔞
放射	放射 ☢️
輻射	輻射 ☢️
生物危害	生物危害 ☣️
有害	有害 ☣️
白羊座	白羊座 ♈
羊座	羊座 ♈
星座	星座 ♈ ♉ ♊ ♋ ♌ ♍ ♎ ♏ ♐ ♑ ♒ ♓ ⛎
金牛座	金牛座 ♉
牛座	牛座 ♉
雙子座	雙子座 ♊
雙座	雙座 ♊
巨蟹座	巨蟹座 ♋
蟹座	蟹座 ♋
獅子座	獅子座 ♌
獅座	獅座 ♌
處女座	處女座 ♍
女座	女座 ♍
天秤座	天秤座 ♎
秤座	秤座 ♎
天蠍座	天蠍座 ♏
蠍座	蠍座 ♏
射手座	射手座 ♐
手座	手座 ♐
摩羯座	摩羯座 ♑
羯座	羯座 ♑
水瓶座	水瓶座 ♒
瓶座	瓶座 ♒
雙魚座	雙魚座 ♓
魚座	魚座 ♓
蛇夫座	蛇夫座 ⛎
蛇座	蛇座 ⛎
服務鈴	服務鈴 🛎️
呼叫鈴	呼叫鈴 🛎️
旅行箱	旅行箱 🧳
行李箱	行李箱 🧳
體育場	體育場 🏟️
體育館	體育館 🏟️
運動場	運動場 🏟️
比賽場地	比賽場地 🏟️
古典建築	古典建築 🏛️
歷史建築	歷史建築 🏛️
宮殿	宮殿 🏛️
建築施工	建築施工 🏗️
建設	建設 🏗️
現場	現場 🏗️
磚	磚 🧱
砌磚	砌磚 🧱
建材	建材 🧱 🪨
岩石	岩石 🪨
石材	石材 🪨
木材	木材 🪵
木頭	木頭 🪵
樹木	樹木 🪵
小屋	小屋 🛖
茅屋	茅屋 🛖
小木屋	小木屋 🛖
房屋	房屋 🏘️
住宅	住宅 🏘️ 🏠 🏡
住宅區	住宅區 🏘️
廢棄房屋	廢棄房屋 🏚️
破舊房屋	破舊房屋 🏚️
荒廢住宅	荒廢住宅 🏚️
房子	房子 🏠
家庭住宅	家庭住宅 🏠
花園房子	花園房子 🏡
花園	花園 🏡
辦公樓	辦公樓 🏢
商業大樓	商業大樓 🏢
公司樓	公司樓 🏢
日本郵局	日本郵局 🏣
郵局	郵局 🏣 🏤
服務中心	服務中心 🏤
郵政	郵政 🏤
醫院	醫院 🏥
醫療機構	醫療機構 🏥
醫療設施	醫療設施 🏥
銀行	銀行 🏦
金融機構	金融機構 🏦
銀行大樓	銀行大樓 🏦
酒店	酒店 🏨 🛎️ 🧳
旅館	旅館 🏨 🛎️ 🧳
住宿	住宿 🏨 🛎️ 🧳
情侶酒店	情侶酒店 🏩
愛情旅館	愛情旅館 🏩
便利店	便利店 🏪
小商店	小商店 🏪
超市	超市 🏪
學校	學校 🏫
教育機構	教育機構 🏫
校園	校園 🏫
百貨商店	百貨商店 🏬
商場	商場 🏬
購物中心	購物中心 🏬
工廠	工廠 🏭
生產廠房	生產廠房 🏭
製造廠	製造廠 🏭
日本城堡	日本城堡 🏯
城堡	城堡 🏯 🏰
古城	古城 🏯
古堡	古堡 🏰
皇宮	皇宮 🏰
婚禮	婚禮 💒
結婚禮堂	結婚禮堂 💒
婚宴	婚宴 💒
東京塔	東京塔 🗼
高塔	高塔 🗼
觀光塔	觀光塔 🗼
自由女神像	自由女神像 🗽
自由女神	自由女神 🗽
觀光地標	觀光地標 🗽
雪山	雪山 🏔️
高山	高山 🏔️ ⛰️
冰山	冰山 🏔️
冰雪	冰雪 🏔️
山脈	山脈 🏔️ ⛰️
山	山 ⛰️ 🌋
峰頂	峰頂 ⛰️
火山	火山 🌋
熔岩	熔岩 🌋
龍山	龍山 🌋
富士山	富士山 🗻
日本山	日本山 🗻
神山	神山 🗻
露營	露營 🏕️
帳篷	帳篷 🏕️ ⛺
野營	野營 🏕️
自然露營	自然露營 🏕️
海灘	海灘 🏖️
沙灘	沙灘 🏖️
陽傘	陽傘 🏖️
海邊	海邊 🏖️
沙漠	沙漠 🏜️
荒地	荒地 🏜️
乾燥	乾燥 🏜️
戈壁	戈壁 🏜️
荒島	荒島 🏝️
小島	小島 🏝️
孤島	孤島 🏝️
熱帶島	熱帶島 🏝️
國家公園	國家公園 🏞️
公園	公園 🏞️
保護區	保護區 🏞️
歐非	歐非 🌍
地球	地球 🌍 🌎 🌏 🌐
歐洲	歐洲 🌍
非洲	非洲 🌍
美洲	美洲 🌎
南美	南美 🌎
亞澳	亞澳 🌏
亞洲	亞洲 🌏
經緯	經緯 🌐
全球	全球 🌐 🗺️
地圖	地圖 🌐 🗺️ 🗾 🌍 🌎 🌏 🧭 📍
世界地圖	世界地圖 🗺️
地球地圖	地球地圖 🗺️
日本地圖	日本地圖 🗾
指南針	指南針 🧭
羅盤	羅盤 🧭
方位	方位 🧭
方向	方向 🧭 ⬆️ ↗️ ➡️ ↘️ ⬇️ ↙️ ⬅️ ↖️ ↕️ ↔️ ↩️ ↪️ ⤴️ ⤵️ 🔃 🔄 🔙 🔚 🔛 🔜 🔝
噴泉	噴泉 ⛲
水池	水池 ⛲
景觀水景	景觀水景 ⛲
露營帳篷	露營帳篷 ⛺
野營裝備	野營裝備 ⛺
多霧	多霧 🌁
霧霾	霧霾 🌁 🌫️
視野不清	視野不清 🌁
星空夜晚	星空夜晚 🌃
夜空	夜空 🌃 🌑 ⭐ 🌟
城市景觀	城市景觀 🏙️
都市	都市 🏙️
風景	風景 🏙️
山中日出	山中日出 🌄
日出	日出 🌄 🌅
山景	山景 🌄
清晨	清晨 🌅
朝霞	朝霞 🌅
黃昏城市	黃昏城市 🌆
夜色城市	夜色城市 🌆
日落	日落 🌇 🌆
傍晚	傍晚 🌇
黃昏	黃昏 🌇
夜晚橋	夜晚橋 🌉
夜橋	夜橋 🌉
夜景	夜景 🌉
溫泉	溫泉 ♨️
泉水	泉水 ♨️
養生	養生 ♨️
旋轉木馬	旋轉木馬 🎠
遊樂設施	遊樂設施 🎠 🎡
木馬	木馬 🎠
滑梯	滑梯 🛝
兒童遊樂場	兒童遊樂場 🛝
摩天輪	摩天輪 🎡
觀光輪	觀光輪 🎡
過山車	過山車 🎢
遊樂園	遊樂園 🎢
驚險	驚險 🎢
理髮柱	理髮柱 💈
理髮店	理髮店 💈
馬戲團帳篷	馬戲團帳篷 🎪
露天劇場	露天劇場 🎪
馬戲	馬戲 🎪
教堂	教堂 ⛪
宗教場所	宗教場所 ⛪
基督教堂	基督教堂 ⛪
清真寺	清真寺 🕌
穆斯林寺廟	穆斯林寺廟 🕌
印度教寺廟	印度教寺廟 🛕
神廟	神廟 🛕
猶太教堂	猶太教堂 🕍
猶太會堂	猶太會堂 🕍
會堂	會堂 🕍
神社	神社 ⛩️
日本神社	日本神社 ⛩️
神道	神道 ⛩️
克爾白	克爾白 🕋
聖地	聖地 🕋
朝聖	朝聖 🕋
新月	新月 🌑
盈月	盈月 🌒
月牙	月牙 🌒 🌘 🌙
上弦月	上弦月 🌒 🌓
半月	半月 🌓 🌗
盈凸月	盈凸月 🌔
滿月	滿月 🌕
月圓	月圓 🌕
虧凸月	虧凸月 🌖
下弦月	下弦月 🌗
殘月	殘月 🌘
小月	小月 🌙
新月臉	新月臉 🌚
月亮臉	月亮臉 🌚 🌛 🌜 🌝
上弦月臉	上弦月臉 🌛
下弦月臉	下弦月臉 🌜
溫度計	溫度計 🌡️
氣溫	氣溫 🌡️
太陽	太陽 ☀️ 🌞
日光	日光 ☀️
光輝	光輝 ☀️
滿月臉	滿月臉 🌝
太陽臉	太陽臉 🌞
環行星	環行星 🪐
星球	星球 🪐
天體	天體 🪐
發光星星	發光星星 🌟
流星	流星 🌠
星塵	星塵 🌠
天文	天文 🌠 ☄️
銀河	銀河 🌌
星系	星系 🌌
星空	星空 🌌
雲	雲 ☁️
天氣	天氣 ☁️ ⛅ 🌤️ 🌦️
雲層	雲層 ☁️
雲後太陽	雲後太陽 ⛅
陰天	陰天 ⛅ ☁️ 🌥️
雲雨閃電	雲雨閃電 ⛈️
雷陣雨	雷陣雨 ⛈️
暴風	暴風 ⛈️
小雲後太陽	小雲後太陽 🌤️
晴間多雲	晴間多雲 🌤️
大雲後太陽	大雲後太陽 🌥️
多雲	多雲 🌥️
雨雲後太陽	雨雲後太陽 🌦️
陰雨	陰雨 🌦️
雨雲	雨雲 🌧️
降雨	降雨 🌧️
雪雲	雪雲 🌨️
下雪	下雪 🌨️ ❄️ ⛄
閃電雲	閃電雲 🌩️
雷雲	雷雲 🌩️
龍捲風	龍捲風 🌪️
風暴	風暴 🌪️
霧	霧 🌫️ 🫥
風臉	風臉 🌬️
風的臉	風的臉 🌬️
氣旋	氣旋 🌀
旋風	旋風 🌀
彩虹	彩虹 🌈 🌦️
天氣現象	天氣現象 🌈
收傘	收傘 🌂
雨傘	雨傘 🌂 ☔
傘	傘 ☂️
雨具	雨具 ☂️ ☔
地上傘	地上傘 ⛱️
露天傘	露天傘 ⛱️
高壓	高壓 ⚡
電閃	電閃 ⚡
雪花	雪花 ❄️
冬天	冬天 ❄️
雪人	雪人 ☃️ ⛄
冬季	冬季 ☃️
無雪雪人	無雪雪人 ⛄
彗星	彗星 ☄️
火焰	火焰 🔥
水滴	水滴 💧
水	水 💧 🥛
水波	水波 🌊
沙漏完成	沙漏完成 ⌛
時間到	時間到 ⌛
完成沙漏	完成沙漏 ⌛
沙漏未完成	沙漏未完成 ⏳
計時中	計時中 ⏳
未完成沙漏	未完成沙漏 ⏳
手錶	手錶 ⌚
腕錶	腕錶 ⌚
時間表	時間表 ⌚
手表	手表 ⌚
鬧鐘	鬧鐘 ⏰
醒鐘	醒鐘 ⏰
時間鬧鐘	時間鬧鐘 ⏰
秒錶	秒錶 ⏱️
計時錶	計時錶 ⏱️
計秒器	計秒器 ⏱️
計時器	計時器 ⏲️
定時器	定時器 ⏲️
時間器	時間器 ⏲️
壁爐時鐘	壁爐時鐘 🕰️
擺鐘	擺鐘 🕰️
懷舊鐘	懷舊鐘 🕰️
十二點	十二點 🕛
正午	正午 🕛
十二點半	十二點半 🕧
一點	一點 🕐
一點半	一點半 🕜
兩點	兩點 🕑
兩點半	兩點半 🕝
三點	三點 🕒
三點半	三點半 🕞
四點	四點 🕓
四點半	四點半 🕟
五點	五點 🕔
五點半	五點半 🕠
六點	六點 🕕
六點半	六點半 🕡
七點	七點 🕖
七點半	七點半 🕢
八點	八點 🕗
八點半	八點半 🕣
九點	九點 🕘
九點半	九點半 🕤
十點	十點 🕙
十點半	十點半 🕥
十一點	十一點 🕚
十一點半	十一點半 🕦
飛機	飛機 ✈️ 🛩️
航空器	航空器 ✈️
空中飛行	空中飛行 ✈️
小型飛機	小型飛機 🛩️
小飛機	小飛機 🛩️
小型航空器	小型航空器 🛩️
飛機起飛	飛機起飛 🛫
起飛	起飛 🛫
空中出發	空中出發 🛫
飛機降落	飛機降落 🛬
降落	降落 🛬
空中抵達	空中抵達 🛬
降落傘	降落傘 🪂
空降	空降 🪂
座位	座位 💺
機艙座位	機艙座位 💺
直升機	直升機 🚁
直升機飛行	直升機飛行 🚁
懸掛式鐵路	懸掛式鐵路 🚟
空中鐵道	空中鐵道 🚟
山地纜車	山地纜車 🚠
高山纜車	高山纜車 🚠
空中纜車	空中纜車 🚡
纜車	纜車 🚡
衛星	衛星 🛰️
太空衛星	太空衛星 🛰️
火箭	火箭 🚀
太空火箭	太空火箭 🚀
飛碟	飛碟 🛸
外星飛行器	外星飛行器 🛸
火車頭	火車頭 🚂
火車機車	火車機車 🚂
火車車廂	火車車廂 🚃
車廂	車廂 🚃
高速列車	高速列車 🚄 🚅
高速火車	高速火車 🚄
子彈列車	子彈列車 🚅
火車	火車 🚆 🚄
長途列車	長途列車 🚆
地鐵	地鐵 🚇 🚉
地下鐵	地下鐵 🚇
輕軌	輕軌 🚈
電車	電車 🚈 🚊
車站	車站 🚉
火車站	火車站 🚉
有軌電車	有軌電車 🚊
單軌列車	單軌列車 🚝
單軌鐵路	單軌鐵路 🚝
山地火車	山地火車 🚞
高山列車	高山列車 🚞
電車車廂	電車車廂 🚋
電車座位	電車座位 🚋
公車	公車 🚌 🚏
巴士	巴士 🚌
迎面公車	迎面公車 🚍
來車	來車 🚍
無軌電車	無軌電車 🚎
電動巴士	電動巴士 🚎
小型巴士	小型巴士 🚐
小巴	小巴 🚐
救護車	救護車 🚑
救護車輛	救護車輛 🚑
消防車	消防車 🚒
滅火車	滅火車 🚒
警車	警車 🚓
警察車	警察車 🚓
迎面警車	迎面警車 🚔
警察來車	警察來車 🚔
計程車	計程車 🚕
出租車	出租車 🚕 🚖
迎面計程車	迎面計程車 🚖
計程車來車	計程車來車 🚖
汽車	汽車 🚗
小車	小車 🚗
迎面汽車	迎面汽車 🚘
小車來車	小車來車 🚘
運動型多用途車	運動型多用途車 🚙
SUV	SUV 🚙
皮卡車	皮卡車 🛻
小卡車	小卡車 🛻
貨車	貨車 🚚
配送車	配送車 🚚
聯結卡車	聯結卡車 🚛
大卡車	大卡車 🚛
拖拉機	拖拉機 🚜
農業車	農業車 🚜
賽車	賽車 🏎️
競速車	競速車 🏎️
摩托車	摩托車 🏍️
重型機車	重型機車 🏍️
機車	機車 🛵
小型摩托車	小型摩托車 🛵
行動輪椅	行動輪椅 🦼
自動人力車	自動人力車 🛺
三輪車	三輪車 🛺
單車	單車 🚲
滑板車	滑板車 🛴
優步車	優步車 🛴
滑板	滑板 🛹
滑行板	滑行板 🛹
滾軸溜冰鞋	滾軸溜冰鞋 🛼
溜冰鞋	溜冰鞋 🛼
公車站	公車站 🚏
公交站	公交站 🚏
高速公路	高速公路 🛣️
快速道路	快速道路 🛣️
鐵路軌道	鐵路軌道 🛤️
鐵道	鐵道 🛤️
油桶	油桶 🛢️
油罐	油罐 🛢️
加油站	加油站 ⛽
油站	油站 ⛽
車輪	車輪 🛞
輪胎	輪胎 🛞
警車燈	警車燈 🚨
警示燈	警示燈 🚨
水平交通燈	水平交通燈 🚥
交通信號燈	交通信號燈 🚥
垂直交通燈	垂直交通燈 🚦
交通燈	交通燈 🚦
停車標誌	停車標誌 🛑
停車標誌牌	停車標誌牌 🛑
施工	施工 🚧
工地	工地 🚧
錨	錨 ⚓
船錨	船錨 ⚓
船隻固定	船隻固定 ⚓
救生圈	救生圈 🛟
救生器	救生器 🛟
安全圈	安全圈 🛟
帆船	帆船 ⛵
小帆船	小帆船 ⛵
獨木舟	獨木舟 🛶
小舟	小舟 🛶
快艇	快艇 🚤
汽艇	汽艇 🚤
客船	客船 🛳️
觀光船	觀光船 🛳️
渡輪	渡輪 ⛴️
輪渡	輪渡 ⛴️
交通船	交通船 ⛴️
機動船	機動船 🛥️
小型機船	小型機船 🛥️
船	船 🚢
大船	大船 🚢
運輸船	運輸船 🚢
藝術	藝術 🎭 🖼️ 🎨 🧵 🪡 🧶 🪢
工藝	工藝 🎭 🖼️ 🎨 🧵 🪡 🧶 🪢
創作	創作 🎭 🖼️ 🎨 🧵 🪡 🧶 🪢
活動	活動 🎃 🎄 🎆 🎇 🧨 ✨ 🎈 🎉 🎊 🎋 🎍 🎎 🎏 🎐 🎑 🧧 🎀 🎁 🎗️ 🎟️ 🎫 💆 💇 🚶 🚶‍➡️ 🧍 🧎 🧎‍➡️ 🧑‍🦯 🧑‍🦯‍➡️ 🧑‍🦼 🧑‍🦼‍➡️ 🧑‍🦽 🧑‍🦽‍➡️ 🏃 🏃‍➡️ 💃 🕺 🕴️ 👯 🧖 🧗 🤺 🏇 ⛷️ 🏂 🏌️ 🏄 🚣 🏊 ⛹️ 🏋️ 🚴 🚵 🤸 🤼 🤽 🤾 🤹
節日	節日 🎃 🎄 🎆 🎇 🧨 ✨ 🎈 🎉 🎊 🎋 🎍 🎎 🎏 🎐 🎑 🧧 🎀 🎁 🎗️ 🎟️ 🎫
慶典	慶典 🎃 🎄 🎆 🎇 🧨 ✨ 🎈 🎉 🎊 🎋 🎍 🎎 🎏 🎐 🎑 🧧 🎀 🎁 🎗️ 🎟️ 🎫
聚會	聚會 🎃 🎄 🎆 🎇 🧨 ✨ 🎈 🎉 🎊 🎋 🎍 🎎 🎏 🎐 🎑 🧧 🎀 🎁 🎗️ 🎟️ 🎫 🍻
娛樂	娛樂 🎯 🪀 🪁 🔫 🎱 🔮 🪄 🎮 🕹️ 🎰 🎲 🧩 🧸 🪅 🪩 🪆 ♠️ ♥️ ♦️ ♣️ ♟️ 🃏 🀄 🎴
玩具	玩具 🎯 🪀 🪁 🔫 🎱 🔮 🪄 🎮 🕹️ 🎰 🎲 🧩 🧸 🪅 🪩 🪆 ♠️ ♥️ ♦️ ♣️ ♟️ 🃏 🀄 🎴
體育	體育 ⚽ ⚾ 🥎 🏀 🏐 🏈 🏉 🎾 🥏 🎳 🏏 🏑 🏒 🥍 🏓 🏸 🥊 🥋 🥅 ⛳ ⛸️ 🎣 🤿 🎽 🎿 🛷 🥌
比賽	比賽 ⚽ ⚾ 🥎 🏀 🏐 🏈 🏉 🎾 🥏 🎳 🏏 🏑 🏒 🥍 🏓 🏸 🥊 🥋 🥅 ⛳ ⛸️ 🎣 🤿 🎽 🎿 🛷 🥌
兩棲	兩棲 🐸
動物	動物 🐸 🦃 🐔 🐓 🐣 🐤 🐥 🐦 🐧 🕊️ 🦅 🦆 🦢 🦉 🦤 🪶 🦩 🦚 🦜 🪽 🐦‍⬛ 🪿 🐦‍🔥 🐌 🦋 🐛 🐜 🐝 🪲 🐞 🦗 🪳 🕷️ 🕸️ 🦂 🦟 🪰 🪱 🦠 🐵 🐒 🦍 🦧 🐶 🐕 🦮 🐕‍🦺 🐩 🐺 🦊 🦝 🐱 🐈 🐈‍⬛ 🦁 🐯 🐅 🐆 🐴 🫎 🫏 🐎 🦄 🦓 🦌 🦬 🐮 🐂 🐃 🐄 🐷 🐖 🐗 🐽 🐏 🐑 🐐 🐪 🐫 🦙 🦒 🐘 🦣 🦏 🦛 🐭 🐁 🐀 🐹 🐰 🐇 🐿️ 🦫 🦔 🦇 🐻 🐻‍❄️ 🐨 🐼 🦥 🦦 🦨 🦘 🦡 🐾 🐳 🐋 🐬 🦭 🐟 🐠 🐡 🦈 🐙 🐚 🪸 🪼 🦀 🦞 🦐 🦑 🦪 🐊 🐢 🦎 🐍 🐲 🐉 🦕 🦖
水陸	水陸 🐸
飛禽	飛禽 🦃 🐔 🐓 🐣 🐤 🐥 🐦 🐧 🕊️ 🦅 🦆 🦢 🦉 🦤 🪶 🦩 🦚 🦜 🪽 🐦‍⬛ 🪿 🐦‍🔥
獸類	獸類 🐵 🐒 🦍 🦧 🐶 🐕 🦮 🐕‍🦺 🐩 🐺 🦊 🦝 🐱 🐈 🐈‍⬛ 🦁 🐯 🐅 🐆 🐴 🫎 🫏 🐎 🦄 🦓 🦌 🦬 🐮 🐂 🐃 🐄 🐷 🐖 🐗 🐽 🐏 🐑 🐐 🐪 🐫 🦙 🦒 🐘 🦣 🦏 🦛 🐭 🐁 🐀 🐹 🐰 🐇 🐿️ 🦫 🦔 🦇 🐻 🐻‍❄️ 🐨 🐼 🦥 🦦 🦨 🦘 🦡 🐾
哺乳類	哺乳類 🐵 🐒 🦍 🦧 🐶 🐕 🦮 🐕‍🦺 🐩 🐺 🦊 🦝 🐱 🐈 🐈‍⬛ 🦁 🐯 🐅 🐆 🐴 🫎 🫏 🐎 🦄 🦓 🦌 🦬 🐮 🐂 🐃 🐄 🐷 🐖 🐗 🐽 🐏 🐑 🐐 🐪 🐫 🦙 🦒 🐘 🦣 🦏 🦛 🐭 🐁 🐀 🐹 🐰 🐇 🐿️ 🦫 🦔 🦇 🐻 🐻‍❄️ 🐨 🐼 🦥 🦦 🦨 🦘 🦡 🐾
海洋	海洋 🐳 🐋 🐬 🦭 🐟 🐠 🐡 🦈 🐙 🐚 🪸 🪼 🦀 🦞 🦐 🦑 🦪
水中	水中 🐳 🐋 🐬 🦭 🐟 🐠 🐡 🦈 🐙 🐚 🪸 🪼 🦀 🦞 🦐 🦑 🦪
爬行	爬行 🐊 🐢 🦎 🐍 🐲 🐉 🦕 🦖
陸地	陸地 🐊 🐢 🦎 🐍 🐲 🐉 🦕 🦖
花卉	花卉 💐 🌸 💮 🪷 🏵️ 🌹 🥀 🌺 🌻 🌼 🌷 🪻
植物	植物 💐 🌸 💮 🪷 🏵️ 🌹 🥀 🌺 🌻 🌼 🌷 🪻 🌱 🪴 🌲 🌳 🌴 🌵 🌾 🌿 ☘️ 🍀 🍁 🍂 🍃 🪹 🪺 🍄 🪾
木	木 🌱 🪴 🌲 🌳 🌴 🌵 🌾 🌿 ☘️ 🍀 🍁 🍂 🍃 🪹 🪺 🍄 🪾
國旗	國旗 🇦🇨 🇦🇩 🇦🇪 🇦🇫 🇦🇬 🇦🇮 🇦🇱 🇦🇲 🇦🇴 🇦🇶 🇦🇷 🇦🇸 🇦🇹 🇦🇺 🇦🇼 🇦🇽 🇦🇿 🇧🇦 🇧🇧 🇧🇩 🇧🇪 🇧🇫 🇧🇬 🇧🇭 🇧🇮 🇧🇯 🇧🇱 🇧🇲 🇧🇳 🇧🇴 🇧🇶 🇧🇷 🇧🇸 🇧🇹 🇧🇻 🇧🇼 🇧🇾 🇧🇿 🇨🇦 🇨🇨 🇨🇩 🇨🇫 🇨🇬 🇨🇭 🇨🇮 🇨🇰 🇨🇱 🇨🇲 🇨🇳 🇨🇴 🇨🇵 🇨🇶 🇨🇷 🇨🇺 🇨🇻 🇨🇼 🇨🇽 🇨🇾 🇨🇿 🇩🇪 🇩🇬 🇩🇯 🇩🇰 🇩🇲 🇩🇴 🇩🇿 🇪🇦 🇪🇨 🇪🇪 🇪🇬 🇪🇭 🇪🇷 🇪🇸 🇪🇹 🇪🇺 🇫🇮 🇫🇯 🇫🇰 🇫🇲 🇫🇴 🇫🇷 🇬🇦 🇬🇧 🇬🇩 🇬🇪 🇬🇫 🇬🇬 🇬🇭 🇬🇮 🇬🇱 🇬🇲 🇬🇳 🇬🇵 🇬🇶 🇬🇷 🇬🇸 🇬🇹 🇬🇺 🇬🇼 🇬🇾 🇭🇰 🇭🇲 🇭🇳 🇭🇷 🇭🇹 🇭🇺 🇮🇨 🇮🇩 🇮🇪 🇮🇱 🇮🇲 🇮🇳 🇮🇴 🇮🇶 🇮🇷 🇮🇸 🇮🇹 🇯🇪 🇯🇲 🇯🇴 🇯🇵 🇰🇪 🇰🇬 🇰🇭 🇰🇮 🇰🇲 🇰🇳 🇰🇵 🇰🇷 🇰🇼 🇰🇾 🇰🇿 🇱🇦 🇱🇧 🇱🇨 🇱🇮 🇱🇰 🇱🇷 🇱🇸 🇱🇹 🇱🇺 🇱🇻 🇱🇾 🇲🇦 🇲🇨 🇲🇩 🇲🇪 🇲🇫 🇲🇬 🇲🇭 🇲🇰 🇲🇱 🇲🇲 🇲🇳 🇲🇴 🇲🇵 🇲🇶 🇲🇷 🇲🇸 🇲🇹 🇲🇺 🇲🇻 🇲🇼 🇲🇽 🇲🇾 🇲🇿 🇳🇦 🇳🇨 🇳🇪 🇳🇫 🇳🇬 🇳🇮 🇳🇱 🇳🇴 🇳🇵 🇳🇷 🇳🇺 🇳🇿 🇴🇲 🇵🇦 🇵🇪 🇵🇫 🇵🇬 🇵🇭 🇵🇰 🇵🇱 🇵🇲 🇵🇳 🇵🇷 🇵🇸 🇵🇹 🇵🇼 🇵🇾 🇶🇦 🇷🇪 🇷🇴 🇷🇸 🇷🇺 🇷🇼 🇸🇦 🇸🇧 🇸🇨 🇸🇩 🇸🇪 🇸🇬 🇸🇭 🇸🇮 🇸🇯 🇸🇰 🇸🇱 🇸🇲 🇸🇳 🇸🇴 🇸🇷 🇸🇸 🇸🇹 🇸🇻 🇸🇽 🇸🇾 🇸🇿 🇹🇦 🇹🇨 🇹🇩 🇹🇫 🇹🇬 🇹🇭 🇹🇯 🇹🇰 🇹🇱 🇹🇲 🇹🇳 🇹🇴 🇹🇷 🇹🇹 🇹🇻 🇹🇼 🇹🇿 🇺🇦 🇺🇬 🇺🇲 🇺🇳 🇺🇸 🇺🇾 🇺🇿 🇻🇦 🇻🇨 🇻🇪 🇻🇬 🇻🇮 🇻🇳 🇻🇺 🇼🇫 🇼🇸 🇽🇰 🇾🇪 🇾🇹 🇿🇦 🇿🇲 🇿🇼
國家旗幟	國家旗幟 🇦🇨 🇦🇩 🇦🇪 🇦🇫 🇦🇬 🇦🇮 🇦🇱 🇦🇲 🇦🇴 🇦🇶 🇦🇷 🇦🇸 🇦🇹 🇦🇺 🇦🇼 🇦🇽 🇦🇿 🇧🇦 🇧🇧 🇧🇩 🇧🇪 🇧🇫 🇧🇬 🇧🇭 🇧🇮 🇧🇯 🇧🇱 🇧🇲 🇧🇳 🇧🇴 🇧🇶 🇧🇷 🇧🇸 🇧🇹 🇧🇻 🇧🇼 🇧🇾 🇧🇿 🇨🇦 🇨🇨 🇨🇩 🇨🇫 🇨🇬 🇨🇭 🇨🇮 🇨🇰 🇨🇱 🇨🇲 🇨🇳 🇨🇴 🇨🇵 🇨🇶 🇨🇷 🇨🇺 🇨🇻 🇨🇼 🇨🇽 🇨🇾 🇨🇿 🇩🇪 🇩🇬 🇩🇯 🇩🇰 🇩🇲 🇩🇴 🇩🇿 🇪🇦 🇪🇨 🇪🇪 🇪🇬 🇪🇭 🇪🇷 🇪🇸 🇪🇹 🇪🇺 🇫🇮 🇫🇯 🇫🇰 🇫🇲 🇫🇴 🇫🇷 🇬🇦 🇬🇧 🇬🇩 🇬🇪 🇬🇫 🇬🇬 🇬🇭 🇬🇮 🇬🇱 🇬🇲 🇬🇳 🇬🇵 🇬🇶 🇬🇷 🇬🇸 🇬🇹 🇬🇺 🇬🇼 🇬🇾 🇭🇰 🇭🇲 🇭🇳 🇭🇷 🇭🇹 🇭🇺 🇮🇨 🇮🇩 🇮🇪 🇮🇱 🇮🇲 🇮🇳 🇮🇴 🇮🇶 🇮🇷 🇮🇸 🇮🇹 🇯🇪 🇯🇲 🇯🇴 🇯🇵 🇰🇪 🇰🇬 🇰🇭 🇰🇮 🇰🇲 🇰🇳 🇰🇵 🇰🇷 🇰🇼 🇰🇾 🇰🇿 🇱🇦 🇱🇧 🇱🇨 🇱🇮 🇱🇰 🇱🇷 🇱🇸 🇱🇹 🇱🇺 🇱🇻 🇱🇾 🇲🇦 🇲🇨 🇲🇩 🇲🇪 🇲🇫 🇲🇬 🇲🇭 🇲🇰 🇲🇱 🇲🇲 🇲🇳 🇲🇴 🇲🇵 🇲🇶 🇲🇷 🇲🇸 🇲🇹 🇲🇺 🇲🇻 🇲🇼 🇲🇽 🇲🇾 🇲🇿 🇳🇦 🇳🇨 🇳🇪 🇳🇫 🇳🇬 🇳🇮 🇳🇱 🇳🇴 🇳🇵 🇳🇷 🇳🇺 🇳🇿 🇴🇲 🇵🇦 🇵🇪 🇵🇫 🇵🇬 🇵🇭 🇵🇰 🇵🇱 🇵🇲 🇵🇳 🇵🇷 🇵🇸 🇵🇹 🇵🇼 🇵🇾 🇶🇦 🇷🇪 🇷🇴 🇷🇸 🇷🇺 🇷🇼 🇸🇦 🇸🇧 🇸🇨 🇸🇩 🇸🇪 🇸🇬 🇸🇭 🇸🇮 🇸🇯 🇸🇰 🇸🇱 🇸🇲 🇸🇳 🇸🇴 🇸🇷 🇸🇸 🇸🇹 🇸🇻 🇸🇽 🇸🇾 🇸🇿 🇹🇦 🇹🇨 🇹🇩 🇹🇫 🇹🇬 🇹🇭 🇹🇯 🇹🇰 🇹🇱 🇹🇲 🇹🇳 🇹🇴 🇹🇷 🇹🇹 🇹🇻 🇹🇼 🇹🇿 🇺🇦 🇺🇬 🇺🇲 🇺🇳 🇺🇸 🇺🇾 🇺🇿 🇻🇦 🇻🇨 🇻🇪 🇻🇬 🇻🇮 🇻🇳 🇻🇺 🇼🇫 🇼🇸 🇽🇰 🇾🇪 🇾🇹 🇿🇦 🇿🇲 🇿🇼
國家標誌	國家標誌 🇦🇨 🇦🇩 🇦🇪 🇦🇫 🇦🇬 🇦🇮 🇦🇱 🇦🇲 🇦🇴 🇦🇶 🇦🇷 🇦🇸 🇦🇹 🇦🇺 🇦🇼 🇦🇽 🇦🇿 🇧🇦 🇧🇧 🇧🇩 🇧🇪 🇧🇫 🇧🇬 🇧🇭 🇧🇮 🇧🇯 🇧🇱 🇧🇲 🇧🇳 🇧🇴 🇧🇶 🇧🇷 🇧🇸 🇧🇹 🇧🇻 🇧🇼 🇧🇾 🇧🇿 🇨🇦 🇨🇨 🇨🇩 🇨🇫 🇨🇬 🇨🇭 🇨🇮 🇨🇰 🇨🇱 🇨🇲 🇨🇳 🇨🇴 🇨🇵 🇨🇶 🇨🇷 🇨🇺 🇨🇻 🇨🇼 🇨🇽 🇨🇾 🇨🇿 🇩🇪 🇩🇬 🇩🇯 🇩🇰 🇩🇲 🇩🇴 🇩🇿 🇪🇦 🇪🇨 🇪🇪 🇪🇬 🇪🇭 🇪🇷 🇪🇸 🇪🇹 🇪🇺 🇫🇮 🇫🇯 🇫🇰 🇫🇲 🇫🇴 🇫🇷 🇬🇦 🇬🇧 🇬🇩 🇬🇪 🇬🇫 🇬🇬 🇬🇭 🇬🇮 🇬🇱 🇬🇲 🇬🇳 🇬🇵 🇬🇶 🇬🇷 🇬🇸 🇬🇹 🇬🇺 🇬🇼 🇬🇾 🇭🇰 🇭🇲 🇭🇳 🇭🇷 🇭🇹 🇭🇺 🇮🇨 🇮🇩 🇮🇪 🇮🇱 🇮🇲 🇮🇳 🇮🇴 🇮🇶 🇮🇷 🇮🇸 🇮🇹 🇯🇪 🇯🇲 🇯🇴 🇯🇵 🇰🇪 🇰🇬 🇰🇭 🇰🇮 🇰🇲 🇰🇳 🇰🇵 🇰🇷 🇰🇼 🇰🇾 🇰🇿 🇱🇦 🇱🇧 🇱🇨 🇱🇮 🇱🇰 🇱🇷 🇱🇸 🇱🇹 🇱🇺 🇱🇻 🇱🇾 🇲🇦 🇲🇨 🇲🇩 🇲🇪 🇲🇫 🇲🇬 🇲🇭 🇲🇰 🇲🇱 🇲🇲 🇲🇳 🇲🇴 🇲🇵 🇲🇶 🇲🇷 🇲🇸 🇲🇹 🇲🇺 🇲🇻 🇲🇼 🇲🇽 🇲🇾 🇲🇿 🇳🇦 🇳🇨 🇳🇪 🇳🇫 🇳🇬 🇳🇮 🇳🇱 🇳🇴 🇳🇵 🇳🇷 🇳🇺 🇳🇿 🇴🇲 🇵🇦 🇵🇪 🇵🇫 🇵🇬 🇵🇭 🇵🇰 🇵🇱 🇵🇲 🇵🇳 🇵🇷 🇵🇸 🇵🇹 🇵🇼 🇵🇾 🇶🇦 🇷🇪 🇷🇴 🇷🇸 🇷🇺 🇷🇼 🇸🇦 🇸🇧 🇸🇨 🇸🇩 🇸🇪 🇸🇬 🇸🇭 🇸🇮 🇸🇯 🇸🇰 🇸🇱 🇸🇲 🇸🇳 🇸🇴 🇸🇷 🇸🇸 🇸🇹 🇸🇻 🇸🇽 🇸🇾 🇸🇿 🇹🇦 🇹🇨 🇹🇩 🇹🇫 🇹🇬 🇹🇭 🇹🇯 🇹🇰 🇹🇱 🇹🇲 🇹🇳 🇹🇴 🇹🇷 🇹🇹 🇹🇻 🇹🇼 🇹🇿 🇺🇦 🇺🇬 🇺🇲 🇺🇳 🇺🇸 🇺🇾 🇺🇿 🇻🇦 🇻🇨 🇻🇪 🇻🇬 🇻🇮 🇻🇳 🇻🇺 🇼🇫 🇼🇸 🇽🇰 🇾🇪 🇾🇹 🇿🇦 🇿🇲 🇿🇼
旗幟	旗幟 🏁 🚩 🎌 🏴 🏳️ 🏳️‍🌈 🏳️‍⚧️ 🏴‍☠️
旗子	旗子 🏁 🚩 🎌 🏴 🏳️ 🏳️‍🌈 🏳️‍⚧️ 🏴‍☠️
區旗	區旗 🏴󠁧󠁢󠁥󠁮󠁧󠁿 🏴󠁧󠁢󠁳󠁣󠁴󠁿 🏴󠁧󠁢󠁷󠁬󠁳󠁿
區域旗幟	區域旗幟 🏴󠁧󠁢󠁥󠁮󠁧󠁿 🏴󠁧󠁢󠁳󠁣󠁴󠁿 🏴󠁧󠁢󠁷󠁬󠁳󠁿
區域標誌	區域標誌 🏴󠁧󠁢󠁥󠁮󠁧󠁿 🏴󠁧󠁢󠁳󠁣󠁴󠁿 🏴󠁧󠁢󠁷󠁬󠁳󠁿
飲料	飲料 🍼 🥛 ☕ 🫖 🍵 🍶 🍾 🍷 🍸 🍹 🍺 🍻 🥂 🥃 🫗 🥤 🧋 🧃 🧉 🧊
液體	液體 🍼 🥛 ☕ 🫖 🍵 🍶 🍾 🍷 🍸 🍹 🍺 🍻 🥂 🥃 🫗 🥤 🧋 🧃 🧉 🧊
飲品	飲品 🍼 🥛 ☕ 🫖 🍵 🍶 🍾 🍷 🍸 🍹 🍺 🍻 🥂 🥃 🫗 🥤 🧋 🧃 🧉 🧊
亞洲美食	亞洲美食 🍱 🍘 🍙 🍚 🍛 🍜 🍝 🍠 🍢 🍣 🍤 🍥 🥮 🍡 🥟 🥠 🥡
東方美食	東方美食 🍱 🍘 🍙 🍚 🍛 🍜 🍝 🍠 🍢 🍣 🍤 🍥 🥮 🍡 🥟 🥠 🥡
亞洲菜	亞洲菜 🍱 🍘 🍙 🍚 🍛 🍜 🍝 🍠 🍢 🍣 🍤 🍥 🥮 🍡 🥟 🥠 🥡
水果	水果 🍇 🍈 🍉 🍊 🍋 🍋‍🟩 🍌 🍍 🥭 🍎 🍏 🍐 🍑 🍒 🍓 🫐 🥝 🍅 🫒 🥥
果實	果實 🍇 🍈 🍉 🍊 🍋 🍋‍🟩 🍌 🍍 🥭 🍎 🍏 🍐 🍑 🍒 🍓 🫐 🥝 🍅 🫒 🥥
果類	果類 🍇 🍈 🍉 🍊 🍋 🍋‍🟩 🍌 🍍 🥭 🍎 🍏 🍐 🍑 🍒 🍓 🫐 🥝 🍅 🫒 🥥
熟食	熟食 🍞 🥐 🥖 🫓 🥨 🥯 🥞 🧇 🧀 🍖 🍗 🥩 🥓 🍔 🍟 🍕 🌭 🥪 🌮 🌯 🫔 🥙 🧆 🥚 🍳 🥘 🍲 🫕 🥣 🥗 🍿 🧈 🧂 🥫
熟菜	熟菜 🍞 🥐 🥖 🫓 🥨 🥯 🥞 🧇 🧀 🍖 🍗 🥩 🥓 🍔 🍟 🍕 🌭 🥪 🌮 🌯 🫔 🥙 🧆 🥚 🍳 🥘 🍲 🫕 🥣 🥗 🍿 🧈 🧂 🥫
熟品	熟品 🍞 🥐 🥖 🫓 🥨 🥯 🥞 🧇 🧀 🍖 🍗 🥩 🥓 🍔 🍟 🍕 🌭 🥪 🌮 🌯 🫔 🥙 🧆 🥚 🍳 🥘 🍲 🫕 🥣 🥗 🍿 🧈 🧂 🥫
甜食	甜食 🍦 🍧 🍨 🍩 🍪 🎂 🍰 🧁 🥧 🍫 🍬 🍭 🍮 🍯
蔬菜	蔬菜 🥑 🍆 🥔 🥕 🌽 🌶️ 🫑 🥒 🥬 🥦 🧄 🧅 🥜 🫘 🌰 🫚 🫛 🍄‍🟫 🫜
菜類	菜類 🥑 🍆 🥔 🥕 🌽 🌶️ 🫑 🥒 🥬 🥦 🧄 🧅 🥜 🫘 🌰 🫚 🫛 🍄‍🟫 🫜
書紙	書紙 📔 📕 📖 📗 📘 📙 📚 📓 📒 📃 📜 📄 📰 🗞️ 📑 🔖 🏷️
文具	文具 📔 📕 📖 📗 📘 📙 📚 📓 📒 📃 📜 📄 📰 🗞️ 📑 🔖 🏷️ 💼 📁 📂 🗂️ 📅 📆 🗒️ 🗓️ 📇 📈 📉 📊 📋 📌 📍 📎 🖇️ 📏 📐 ✂️ 🗃️ 🗄️ 🗑️ ✏️ ✒️ 🖋️ 🖊️ 🖌️ 🖍️ 📝
衣服	衣服 👓 🕶️ 🥽 🥼 🦺 👔 👕 👖 🧣 🧤 🧥 🧦 👗 👘 🥻 🩱 🩲 🩳 👙 👚 🪭 👛 👜 👝 🛍️ 🎒 🩴 👞 👟 🥾 🥿 👠 👡 🩰 👢 🪮 👑 👒 🎩 🎓 🧢 🪖 ⛑️ 📿 💄 💍 💎
服裝	服裝 👓 🕶️ 🥽 🥼 🦺 👔 👕 👖 🧣 🧤 🧥 🧦 👗 👘 🥻 🩱 🩲 🩳 👙 👚 🪭 👛 👜 👝 🛍️ 🎒 🩴 👞 👟 🥾 🥿 👠 👡 🩰 👢 🪮 👑 👒 🎩 🎓 🧢 🪖 ⛑️ 📿 💄 💍 💎
穿戴	穿戴 👓 🕶️ 🥽 🥼 🦺 👔 👕 👖 🧣 🧤 🧥 🧦 👗 👘 🥻 🩱 🩲 🩳 👙 👚 🪭 👛 👜 👝 🛍️ 🎒 🩴 👞 👟 🥾 🥿 👠 👡 🩰 👢 🪮 👑 👒 🎩 🎓 🧢 🪖 ⛑️ 📿 💄 💍 💎
計算機	計算機 🔋 🪫 🔌 💻 🖥️ 🖨️ ⌨️ 🖱️ 🖲️ 💽 💾 💿 📀 🧮
信息設備	信息設備 🔋 🪫 🔌 💻 🖥️ 🖨️ ⌨️ 🖱️ 🖲️ 💽 💾 💿 📀 🧮
家居	家居 🚪 🛗 🪞 🪟 🛏️ 🛋️ 🪑 🚽 🪠 🚿 🛁 🪤 🪒 🧴 🧷 🧹 🧺 🧻 🪣 🧼 🫧 🪥 🧽 🧯 🛒
生活	生活 🚪 🛗 🪞 🪟 🛏️ 🛋️ 🪑 🚽 🪠 🚿 🛁 🪤 🪒 🧴 🧷 🧹 🧺 🧻 🪣 🧼 🫧 🪥 🧽 🧯 🛒
光影	光影 🎥 🎞️ 📽️ 🎬 📺 📷 📸 📹 📼 🔍 🔎 🕯️ 💡 🔦 🏮 🪔
安全	安全 🔒 🔓 🔏 🔐 🔑 🗝️
信件	信件 ✉️ 📧 📨 📩 📤 📥 📦 📫 📪 📬 📭 📮 🗳️
通訊	通訊 ✉️ 📧 📨 📩 📤 📥 📦 📫 📪 📬 📭 📮 🗳️ 📱 📲 ☎️ 📞 📟 📠
治療	治療 💉 🩸 💊 🩹 🩼 🩺 🩻
貨幣	貨幣 💰 🪙 💴 💵 💶 💷 💸 💳 🧾 💹 💱 💲
樂曲	樂曲 🎼 🎵 🎶 🎙️ 🎚️ 🎛️ 🎤 🎧 📻
歌聲	歌聲 🎼 🎵 🎶 🎙️ 🎚️ 🎛️ 🎤 🎧 📻
樂器	樂器 🎷 🪗 🎸 🎹 🎺 🎻 🪕 🥁 🪘 🪇 🪈 🪉
音樂器材	音樂器材 🎷 🪗 🎸 🎹 🎺 🎻 🪕 🥁 🪘 🪇 🪈 🪉
演奏器材	演奏器材 🎷 🪗 🎸 🎹 🎺 🎻 🪕 🥁 🪘 🪇 🪈 🪉
辦公	辦公 💼 📁 📂 🗂️ 📅 📆 🗒️ 🗓️ 📇 📈 📉 📊 📋 📌 📍 📎 🖇️ 📏 📐 ✂️ 🗃️ 🗄️ 🗑️
文件	文件 💼 📁 📂 🗂️ 📅 📆 🗒️ 🗓️ 📇 📈 📉 📊 📋 📌 📍 📎 🖇️ 📏 📐 ✂️ 🗃️ 🗄️ 🗑️ 📄 📃
其他物品	其他物品 🚬 ⚰️ 🪦 ⚱️ 🧿 🪬 🗿 🪧 🪪
雜物	雜物 🚬 ⚰️ 🪦 ⚱️ 🧿 🪬 🗿 🪧 🪪
物品	物品 🚬 ⚰️ 🪦 ⚱️ 🧿 🪬 🗿 🪧 🪪
聯絡	聯絡 📱 📲 ☎️ 📞 📟 📠
實驗	實驗 ⚗️ 🧪 🧫 🧬 🔬 🔭 📡
研究	研究 ⚗️ 🧪 🧫 🧬 🔬 🔭 📡
聲音	聲音 🔇 🔈 🔉 🔊 📢 📣 📯 🔔 🔕
音效	音效 🔇 🔈 🔉 🔊 📢 📣 📯 🔔 🔕
噪音	噪音 🔇 🔈 🔉 🔊 📢 📣 📯 🔔 🔕
工具	工具 🔨 🪓 ⛏️ ⚒️ 🛠️ 🗡️ ⚔️ 💣 🪃 🏹 🛡️ 🪚 🔧 🪛 🔩 ⚙️ 🗜️ ⚖️ 🦯 🔗 ⛓️‍💥 ⛓️ 🪝 🧰 🧲 🪜 🪏
器材	器材 🔨 🪓 ⛏️ ⚒️ 🛠️ 🗡️ ⚔️ 💣 🪃 🏹 🛡️ 🪚 🔧 🪛 🔩 ⚙️ 🗜️ ⚖️ 🦯 🔗 ⛓️‍💥 ⛓️ 🪝 🧰 🧲 🪜 🪏
設備	設備 🔨 🪓 ⛏️ ⚒️ 🛠️ 🗡️ ⚔️ 💣 🪃 🏹 🛡️ 🪚 🔧 🪛 🔩 ⚙️ 🗜️ ⚖️ 🦯 🔗 ⛓️‍💥 ⛓️ 🪝 🧰 🧲 🪜 🪏
身體	身體 💪 🦾 🦿 🦵 🦶 👂 🦻 👃 🧠 🫀 🫁 🦷 🦴 👀 👁️ 👅 👄 🫦
部位	部位 💪 🦾 🦿 🦵 🦶 👂 🦻 👃 🧠 🫀 🫁 🦷 🦴 👀 👁️ 👅 👄 🫦
器官	器官 💪 🦾 🦿 🦵 🦶 👂 🦻 👃 🧠 🫀 🫁 🦷 🦴 👀 👁️ 👅 👄 🫦
親情	親情 🧑‍🤝‍🧑 👭 👫 👬 💏 💑
手指張開	手指張開 👋 🤚 🖐️ ✋ 🖖 🫱 🫲 🫳 🫴 🫷 🫸
手指部分	手指部分 👌 🤌 🤏 ✌️ 🤞 🫰 🤟 🤘 🤙
手持物	手持物 ✍️ 💅 🤳
指向	指向 👈 👉 👆 🖕 👇 ☝️ 🫵 ⬆️ ↗️ ➡️ ↘️ ⬇️ ↙️ ⬅️ ↖️ ↕️ ↔️ ↩️ ↪️ ⤴️ ⤵️ 🔃 🔄 🔙 🔚 🔛 🔜 🔝
手指	手指 👈 👉 👆 🖕 👇 ☝️ 🫵
單指	單指 👈 👉 👆 🖕 👇 ☝️ 🫵
雙手	雙手 👏 🙌 🫶 👐 🤲 🤝 🙏
動作	動作 💆 💇 🚶 🚶‍➡️ 🧍 🧎 🧎‍➡️ 🧑‍🦯 🧑‍🦯‍➡️ 🧑‍🦼 🧑‍🦼‍➡️ 🧑‍🦽 🧑‍🦽‍➡️ 🏃 🏃‍➡️ 💃 🕺 🕴️ 👯 🧖 🧗 🙍 🙎 🙅 🙆 💁 🙋 🧏 🙇 🤦 🤷
姿勢	姿勢 💆 💇 🚶 🚶‍➡️ 🧍 🧎 🧎‍➡️ 🧑‍🦯 🧑‍🦯‍➡️ 🧑‍🦼 🧑‍🦼‍➡️ 🧑‍🦽 🧑‍🦽‍➡️ 🏃 🏃‍➡️ 💃 🕺 🕴️ 👯 🧖 🧗
幻想角色	幻想角色 👼 🎅 🤶 🧑‍🎄 🦸 🦹 🧙 🧚 🧛 🧜 🧝 🧞 🧟 🧌
魔法	魔法 👼 🎅 🤶 🧑‍🎄 🦸 🦹 🧙 🧚 🧛 🧜 🧝 🧞 🧟 🧌
奇幻	奇幻 👼 🎅 🤶 🧑‍🎄 🦸 🦹 🧙 🧚 🧛 🧜 🧝 🧞 🧟 🧌
表情	表情 🙍 🙎 🙅 🙆 💁 🙋 🧏 🙇 🤦 🤷
休息	休息 🧘 🛀 🛌
靜態	靜態 🧘 🛀 🛌
角色	角色 🧑‍⚕️ 🧑‍🎓 🧑‍🏫 🧑‍⚖️ 🧑‍🌾 🧑‍🍳 🧑‍🔧 🧑‍🏭 🧑‍💼 🧑‍🔬 🧑‍💻 🧑‍🎤 🧑‍🎨 🧑‍✈️ 🧑‍🚀 🧑‍🚒 👮 🕵️ 💂 🥷 👷 🫅 🤴 👸 👳 👲 🧕 🤵 👰 🤰 🫃 🫄 🤱 🧑‍🍼
職業	職業 🧑‍⚕️ 🧑‍🎓 🧑‍🏫 🧑‍⚖️ 🧑‍🌾 🧑‍🍳 🧑‍🔧 🧑‍🏭 🧑‍💼 🧑‍🔬 🧑‍💻 🧑‍🎤 🧑‍🎨 🧑‍✈️ 🧑‍🚀 🧑‍🚒 👮 🕵️ 💂 🥷 👷 🫅 🤴 👸 👳 👲 🧕 🤵 👰 🤰 🫃 🫄 🤱 🧑‍🍼
體能	體能 🤺 🏇 ⛷️ 🏂 🏌️ 🏄 🚣 🏊 ⛹️ 🏋️ 🚴 🚵 🤸 🤼 🤽 🤾 🤹
人物符號	人物符號 🗣️ 👤 👥 🫂 👪 🧑‍🧑‍🧒 🧑‍🧑‍🧒‍🧒 🧑‍🧒 🧑‍🧒‍🧒 👣 🫆
人形符號	人形符號 🗣️ 👤 👥 🫂 👪 🧑‍🧑‍🧒 🧑‍🧑‍🧒‍🧒 🧑‍🧒 🧑‍🧒‍🧒 👣 🫆
人相關	人相關 🗣️ 👤 👥 🫂 👪 🧑‍🧑‍🧒 🧑‍🧑‍🧒‍🧒 🧑‍🧒 🧑‍🧒‍🧒 👣 🫆
個體	個體 👶 🧒 👦 👧 🧑 👱 🧔 🧑‍🦰 🧑‍🦱 🧑‍🦳 🧑‍🦲 🧓 👴 👵
擔憂	擔憂 😕 🫤 😟 🙁 ☹️ 😮 😯 😲 😳 🥺 🥹 😦 😧 😨 😰 😥 😢 😭 😱 😖 😣 😞 😓 😩 😫 🥱
裝扮	裝扮 💩 🤡 👹 👺 👻 👽 👾 🤖
手臉	手臉 🤗 🤭 🫢 🫣 🤫 🤔 🫡
帽臉	帽臉 🤠 🥳 🥸
負面	負面 😤 😡 😠 🤬 😈 👿 💀 ☠️
中性	中性 🤐 🤨 😐 😑 😶 🫥 😶‍🌫️ 😏 😒 🙄 😬 😮‍💨 🤥 🫨 🙂‍↔️ 🙂‍↕️
睡臉	睡臉 😌 😔 😪 🤤 😴 🫩
病臉	病臉 😷 🤒 🤕 🤢 🤮 🤧 🥵 🥶 🥴 😵 😵‍💫 🤯
字母數字	字母數字 🔠 🔡 🔢 🔣 🔤 🅰️ 🆎 🅱️ 🆑 🆒 🆓 ℹ️ 🆔 Ⓜ️ 🆕 🆖 🅾️ 🆗 🅿️ 🆘 🆙 🆚 🈁 🈂️ 🈷️ 🈶 🈯 🉐 🈹 🈚 🈲 🉑 🈸 🈴 🈳 ㊗️ ㊙️ 🈺 🈵
箭頭	箭頭 ⬆️ ↗️ ➡️ ↘️ ⬇️ ↙️ ⬅️ ↖️ ↕️ ↔️ ↩️ ↪️ ⤴️ ⤵️ 🔃 🔄 🔙 🔚 🔛 🔜 🔝
媒體符號	媒體符號 🔀 🔁 🔂 ▶️ ⏩ ⏭️ ⏯️ ◀️ ⏪ ⏮️ 🔼 ⏫ 🔽 ⏬ ⏸️ ⏹️ ⏺️ ⏏️ 🎦 🔅 🔆 📶 🛜 📳 📴
金融	金融 💱 💲
幾何	幾何 🔴 🟠 🟡 🟢 🔵 🟣 🟤 ⚫ ⚪ 🟥 🟧 🟨 🟩 🟦 🟪 🟫 ⬛ ⬜ ◼️ ◻️ ◾ ◽ ▪️ ▫️ 🔶 🔷 🔸 🔹 🔺 🔻 💠 🔘 🔳 🔲
圖形	圖形 🔴 🟠 🟡 🟢 🔵 🟣 🟤 ⚫ ⚪ 🟥 🟧 🟨 🟩 🟦 🟪 🟫 ⬛ ⬜ ◼️ ◻️ ◾ ◽ ▪️ ▫️ 🔶 🔷 🔸 🔹 🔺 🔻 💠 🔘 🔳 🔲
形狀	形狀 🔴 🟠 🟡 🟢 🔵 🟣 🟤 ⚫ ⚪ 🟥 🟧 🟨 🟩 🟦 🟪 🟫 ⬛ ⬜ ◼️ ◻️ ◾ ◽ ▪️ ▫️ 🔶 🔷 🔸 🔹 🔺 🔻 💠 🔘 🔳 🔲
按鍵帽	按鍵帽 #️⃣ *️⃣ 0️⃣ 1️⃣ 2️⃣ 3️⃣ 4️⃣ 5️⃣ 6️⃣ 7️⃣ 8️⃣ 9️⃣ 🔟
按鍵	按鍵 #️⃣ *️⃣ 0️⃣ 1️⃣ 2️⃣ 3️⃣ 4️⃣ 5️⃣ 6️⃣ 7️⃣ 8️⃣ 9️⃣ 🔟
數學	數學 ✖️ ➕ ➖ ➗ 🟰 ♾️
其他符號	其他符號 ⚕️ ♻️ ⚜️ 🔱 📛 🔰 ⭕ ✅ ☑️ ✔️ ❌ ❎ ➰ ➿ 〽️ ✳️ ✴️ ❇️ ©️ ®️ ™️ 🫟
特殊	特殊 ⚕️ ♻️ ⚜️ 🔱 📛 🔰 ⭕ ✅ ☑️ ✔️ ❌ ❎ ➰ ➿ 〽️ ✳️ ✴️ ❇️ ©️ ®️ ™️ 🫟
標點	標點 ‼️ ⁉️ ❓ ❔ ❕ ❗ 〰️
宗教	宗教 🛐 ⚛️ 🕉️ ✡️ ☸️ ☯️ ✝️ ☦️ ☪️ ☮️ 🕎 🔯 🪯 ⛪ 🕌 🛕 🕍 ⛩️ 🕋
神聖	神聖 🛐 ⚛️ 🕉️ ✡️ ☸️ ☯️ ✝️ ☦️ ☪️ ☮️ 🕎 🔯 🪯
交通標誌	交通標誌 🏧 🚮 🚰 ♿ 🚹 🚺 🚻 🚼 🚾 🛂 🛃 🛄 🛅
指示	指示 🏧 🚮 🚰 ♿ 🚹 🚺 🚻 🚼 🚾 🛂 🛃 🛄 🛅
占星	占星 ♈ ♉ ♊ ♋ ♌ ♍ ♎ ♏ ♐ ♑ ♒ ♓ ⛎
十二宮	十二宮 ♈ ♉ ♊ ♋ ♌ ♍ ♎ ♏ ♐ ♑ ♒ ♓ ⛎
建築	建築 🏟️ 🏛️ 🏗️ 🧱 🪨 🪵 🛖 🏘️ 🏚️ 🏠 🏡 🏢 🏣 🏤 🏥 🏦 🏨 🏩 🏪 🏫 🏬 🏭 🏯 🏰 💒 🗼 🗽
地理	地理 🏔️ ⛰️ 🌋 🗻 🏕️ 🏖️ 🏜️ 🏝️ 🏞️
其他	其他 ⛲ ⛺ 🌁 🌃 🏙️ 🌄 🌅 🌆 🌇 🌉 ♨️ 🎠 🛝 🎡 🎢 💈 🎪
天空與天氣	天空與天氣 🌑 🌒 🌓 🌔 🌕 🌖 🌗 🌘 🌙 🌚 🌛 🌜 🌡️ ☀️ 🌝 🌞 🪐 ⭐ 🌟 🌠 🌌 ☁️ ⛅ ⛈️ 🌤️ 🌥️ 🌦️ 🌧️ 🌨️ 🌩️ 🌪️ 🌫️ 🌬️ 🌀 🌈 🌂 ☂️ ☔ ⛱️ ⚡ ❄️ ☃️ ⛄ ☄️ 🔥 💧 🌊
時間	時間 ⌛ ⏳ ⌚ ⏰ ⏱️ ⏲️ 🕰️ 🕛 🕧 🕐 🕜 🕑 🕝 🕒 🕞 🕓 🕟 🕔 🕠 🕕 🕡 🕖 🕢 🕗 🕣 🕘 🕤 🕙 🕥 🕚 🕦
時鐘	時鐘 ⌛ ⏳ ⌚ ⏰ ⏱️ ⏲️ 🕰️ 🕛 🕧 🕐 🕜 🕑 🕝 🕒 🕞 🕓 🕟 🕔 🕠 🕕 🕡 🕖 🕢 🕗 🕣 🕘 🕤 🕙 🕥 🕚 🕦
計時	計時 ⌛ ⏳ ⌚ ⏰ ⏱️ ⏲️ 🕰️ 🕛 🕧 🕐 🕜 🕑 🕝 🕒 🕞 🕓 🕟 🕔 🕠 🕕 🕡 🕖 🕢 🕗 🕣 🕘 🕤 🕙 🕥 🕚 🕦
空中交通	空中交通 ✈️ 🛩️ 🛫 🛬 🪂 💺 🚁 🚟 🚠 🚡 🛰️ 🚀 🛸
陸地交通	陸地交通 🚂 🚃 🚄 🚅 🚆 🚇 🚈 🚉 🚊 🚝 🚞 🚋 🚌 🚍 🚎 🚐 🚑 🚒 🚓 🚔 🚕 🚖 🚗 🚘 🚙 🛻 🚚 🚛 🚜 🏎️ 🏍️ 🛵 🦽 🦼 🛺 🚲 🛴 🛹 🛼 🚏 🛣️ 🛤️ 🛢️ ⛽ 🛞 🚨 🚥 🚦 🛑 🚧
水上交通	水上交通 ⚓ 🛟 ⛵ 🛶 🚤 🛳️ ⛴️ 🛥️ 🚢
架構	架構 🧱 🏗️
模組	模組 📦 🧩
抽象	抽象 🧩 🌀
邏輯	邏輯 ♻️ 🧠
實體	實體 🧬 🧍
用例	用例 🎯 🧭
介面	介面 🧾 🔌
邊界	邊界 🚧 🛑
層級	層級 🧅 📚
流程	流程 🔁 🔂
中介層	中介層 🪟 🚪
驅動	驅動 🧲 ⚡
資源	資源 📚 🛠️
類別	類別 🧱 🗂️
實例	實例 🧍 🧸
策略	策略 🧠 🧭
實作	實作 🛠️ 🔧
依賴	依賴 🧷 🔗
組合	組合 🧩 🤝
分層	分層 🧅 🪜
通道	通道 🛤️
生日	生日 🎂 🎉 🎁 🎈
祝賀	祝賀 🎉 🥂 👏
結婚	結婚 💒 👰 🤵 💍
求婚	求婚 💍 💌 ❤️
情人節	情人節 💘 💝 ❤️
耶誕節	耶誕節 🎄 🎅 🎁
跨年	跨年 🎆 🕛 🥂
新年	新年 🧨 🧧 🐲 🎊
春節	春節 🧧 🧨 🏮
感恩節	感恩節 🦃 🍂 🥧
放假	放假 🌴 🏖️ 🧘
長假	長假 📆 🏝️ 🧳
回家	回家 🏠 🚗 🎒 🚪
吃大餐	吃大餐 🍽️ 🍗 🍰
發紅包	發紅包 🧧 💰
拜年	拜年 🙇 🧧 🎍
撰寫	撰寫 ✍️ ⌨️
編譯	編譯 🛠️ 🧪
建置	建置 🛠️ 🧱
測試	測試 🧪 ✅
除錯	除錯 🐞 🔍 🛠️
模擬	模擬 🎮 🧪
部署	部署 🚀 📦
上線	上線 🚀 ✅
指令	指令 📜 ⌨️
任務	任務 📋 ✅
腳本	腳本 📜 🧾
執行	執行 ▶️ 🟢
重啟	重啟 🔄 ♻️
重試	重試 🔁 🔃
更新	更新 🔃 ♻️ 🔁
同步	同步 🔄 🔁
設定	設定 ⚙️ 🧰
配置	配置 🧰 ⚙️
安裝	安裝 📦 ⬇️
升級	升級 ⬆️ 📈
降級	降級 ⬇️ 📉
版本	版本 🧾 🆚
分支	分支 🌿 🌱
合併	合併 🔀 🤝
衝突	衝突 ⚔️ 💥
比對	比對 🔍 📊
驗證	驗證 🔐 ✅
起床	起床 🌅 ⏰ 😪
刷牙	刷牙 🪥 😬
吃飯	吃飯 🍚 🍱 🍽️
早餐	早餐 🥞 🥚 ☕
午餐	午餐 🍛 🍜 🍲 🥢
晚餐	晚餐 🍝 🍖 🍷
喝水	喝水 💧 🥤
喝咖啡	喝咖啡 ☕ 🫘
出門	出門 🚪 🧥 🧳
通勤	通勤 🚶 🚋 🚇
上班	上班 🏢 💼
工作	工作 💼 👨‍💻 🧰
下班	下班 🌇 🧘
看書	看書 📖 📚
看劇	看劇 📺 🎬
打遊戲	打遊戲 🎮 🕹️
散步	散步 🚶‍♀️ 🌳
洗衣服	洗衣服 🧺 🧼
打掃	打掃 🧹 🧽
購物	購物 🛒 🛍️
買東西	買東西 💸 🛍️ 🛒 💳
煮飯	煮飯 🍳 🥘 🧑‍🍳
出國	出國 🛫 🌍 ✈️
旅行	旅行 🧳 🗺️ ✈️
看醫生	看醫生 🏥 👨‍⚕️ 💊 👩‍⚕️
打電話	打電話 📞 ☎️
傳訊息	傳訊息 💬 📱
資料	資料 📄 🧾
數據	數據 📊 💾
趨勢	趨勢 📈 📉
快取	快取 🧂 🗃️
暫存	暫存 🗃️ 🧊
儲存	儲存 💾 🗄️ 📥
資料庫	資料庫 🗄️ 🧱
查詢	查詢 🔍 🔎
篩選	篩選 🔎 🧹
欄位	欄位 📋 🪪 📄
表格	表格 📊 📋
匯入	匯入 📥 ⬇️
匯出	匯出 📤 ⬆️
異步	異步 ⏳ 🚧
結構	結構 🧱 🧬
類型	類型 🧾 🧠
格式	格式 📐 🔤
對應	對應 🔁 ↔️
對齊	對齊 📏 📐
說明	說明 📖 📚
教學	教學 👨‍🏫 📚
指南	指南 🧭 🗺️
規格	規格 📐 📏
結構圖	結構圖 🗺️ 🧱
註解	註解 🖊️ 🧾
備註	備註 💬 🗒️
表單	表單 📋 📝
清單	清單 🗒️ ✅
範例	範例 🧾 📄
範本	範本 📄 📑
檔案	檔案 📂 🗃️
步驟	步驟 👣 🔢
歷史	歷史 📜 🕰️
記錄	記錄 📝 📜
檢核表	檢核表 ☑️ 🧾
描述	描述 🖋️ 📝
統整	統整 🧾 📚
關聯	關聯 🔗 ➰
限制	限制 ⛓️ 🚫
滿足	滿足 😊 😌 😋
哭	哭 😭 😢 😿
睏	睏 🥱 😪 🛌
有趣	有趣 😆 😹 😄 🎉
好笑	好笑 😂 😹 🤣
煩躁	煩躁 😤 😣 😫
現金	現金 💵 💶 💷
零錢	零錢 🪙 💱
收入	收入 💵 🤑 📈
支出	支出 💸 📉 💳
儲蓄	儲蓄 🏦 💰 🐷
花錢	花錢 🛍️ 💸 💳
節省	節省 💡 🐷 ✂️
價格	價格 🏷️ 💲
付款	付款 💳 💸 📤
支付	支付 💳 📱
匯款	匯款 💸 💱 🏧
收款	收款 📥 🏦
報帳	報帳 🧾 📊
薪水	薪水 💵 📥 👨‍💼
小費	小費 💵 🙇
中獎	中獎 🎰 🎉 💵
投資	投資 📈 📊 💹
股票	股票 📈 📉 💹
財報	財報 📊 🧾 📈
記帳	記帳 🧾 ✍️ 📓
宵夜	宵夜 🌙 🍲 🍢
點心	點心 🍩 🍪 🧁
茶	茶 🍵 🫖
果汁	果汁 🧃 🍊
肉	肉 🍖 🍗 🥩
海鮮	海鮮 🦐 🐟 🦑
炸物	炸物 🍟 🍤 🧆
甜點	甜點 🍰 🍮 🍦
冰品	冰品 🍦 🍧 🧊
烤肉	烤肉 🍖 🔥 🍢
外送	外送 🛵 🛍️ 📦
吃飽	吃飽 😋 🈵
餓	餓 🤤 😩 🍴
咳嗽	咳嗽 😷 🤧
頭痛	頭痛 🤕 😖
痛	痛 😣 😫 😖
睡眠	睡眠 🛌 💤 😴
打瞌睡	打瞌睡 🥱 😪
精神好	精神好 😃 💪 ☀️
掛號	掛號 🏥 📝
住院	住院 🏥 🛏️
出院	出院 🚶 🏠
復原	復原 💪 😊
健檢	健檢 🧪 🔬 🧫
消毒	消毒 🧴 🧼 🔥
飲食	飲食 🍽️ 🥗 🍵
體重	體重 ⚖️ 🧍‍♂️
提示	提示 💡 🔎 🔔
偵測	偵測 🕵️ 🔍
監聽	監聽 👂 📡
輸出	輸出 📤 🖨️
捕捉	捕捉 📸 🧲
跳過	跳過 ⏭️ ⏩
排除	排除 🚷 🚫
忽略	忽略 🙈
停用	停用 🚫 🔕
啟用	啟用 🔓 ✅
重新導向	重新導向 🔁 🔀
加油	加油 💪 👊 🙌
贊成	贊成 ✅ 🤝 👍
反對	反對 ❌ 👎 🙅
討厭	討厭 🤢 👎 🚫
哭哭	哭哭 😢 😭 😿
吐槽	吐槽 🙄 😒 😤
無言	無言 😑 🙃 🤐
拍手	拍手 👏 🙌
高能	高能 ⚡🔥 💥
安慰	安慰 🤗 🫂 💖
推薦	推薦 👍 🌟 💡
不推	不推 👎 ❌ 🚫
留言	留言 💬 🗯️
回覆	回覆 📩 🔁
轉發	轉發 🔁 🔄
爸爸	爸爸 👨 👨‍🦱 👔
媽媽	媽媽 👩 👩‍🦰 🧺
兄弟	兄弟 👦 🤼
姐妹	姐妹 👧 👭
親戚	親戚 👵 👴 🧓
同學	同學 🎒 📚
同事	同事 💼 🧑‍💻
老闆	老闆 🧑‍💼 👨‍💼
交往	交往 💑 🤝
告白	告白 💌 💓
離婚	離婚 💔 🔪
單身	單身 🙋 😎
社交	社交 🗣️ 👥
拜訪	拜訪 🚪 👋
想念	想念 😢 💭 ❤️
分離	分離 🥀 😔
運行	運行 ▶️ 🏃
進行中	進行中 🔄 🔃
等待	等待 ⌛ ⏳
完成	完成 🏁 ✅
成功	成功 ✅ ☑️ ✔️ 🎉
通過	通過 ☑️ ✅
失敗	失敗 ❌ 💥
中止	中止 🛑 ⛔
回傳	回傳 🔙 🔁
團隊	團隊 🧑‍🤝‍🧑 👥
協作	協作 🤝 👯
負責	負責 🙋 📌
派發	派發 📤 📩
回報	回報 📮 📢
意見	意見 💡 💭
共識	共識 🤝 ✨
協議	協議 🤝 📜
會議	會議 📅 🗣️
紀錄	紀錄 📝 📜
提案	提案 📄 🗳️
回饋	回饋 🔁 💬
決策	決策 🧠 ⚖️
支援	支援 🆘 🙋
指引	指引 🧭 📘
計劃	計劃 🗓️ 📝
排程	排程 📅 🧾
通知	通知 🔔 📣
待辦	待辦 📝 ⏳
優先	優先 🔝 🥇
分工	分工 ⚒️ 📤
回國	回國 🛬 🏠
出差	出差 💼 ✈️ 🏨
假期	假期 🏖️ 🌴 🍹
景點	景點 🗼 🏰 🗽
打卡	打卡 📍 📸
行程	行程 🗓️ ✍️ 🧳
訂房	訂房 🏨 🛏️ 🧾
搭飛機	搭飛機 ✈️ 🛫 🛬
高鐵	高鐵 🚄 🛤️
開車	開車 🚗 🛣️
過海關	過海關 🛂 🛃
护照	护照 🛂 📘
登機	登機 🛫 🎫
下機	下機 🛬 🛅
報到	報到 🧾 🛂
選單	選單 📑 ☰
分頁	分頁 📄 📚
頁面	頁面 🖥️ 🧾
圖示	圖示 🖼️ 🎨
清除	清除 ❌ 🧹
提交	提交 📤 📨
取消	取消 ❌ 🚫
編輯	編輯 ✏️ 🖊️
下一步	下一步 ⏭️ ➡️
上一步	上一步 ⏮️ ⬅️
載入中	載入中 🔄 ⏳
展開	展開 ➕ 🔽
收合	收合 ➖ 🔼
拖曳	拖曳 🖱️ ✋
上傳	上傳 ⬆️ 📤
下載	下載 ⬇️ 📥
預覽	預覽 🧐 🖼️
晴天	晴天 ☀️ 🌞 🌤️
陽光	陽光 ☀️ 😎
下雨	下雨 🌧️ 🌦️ ☔
小雨	小雨 🌦️ ☔
大雨	大雨 🌧️ ⛈️
雷雨	雷雨 ⛈️ ⚡🌩️
打雷	打雷 ⚡🌩️
閃電	閃電 ⚡ ⚡️
冰雹	冰雹 🌨️ ❄️
颱風	颱風 🌀 🌪️
強風	強風 🌬️ 💨
露水	露水 💧 🌫️
晚上	晚上 🌙 🌌
天空	天空 🌌 ☁️